date,state_abbrev,positive,negative,total,state_code,state
2020-07-23,AK,2684,186825,189509,02,Alaska
2020-07-23,AL,74212,545315,619527,01,Alabama
2020-07-23,AR,36259,410221,446480,05,Arkansas
2020-07-23,AS,0,1037,1037,60,American Samoa
2020-07-23,AZ,152944,669769,822713,04,Arizona
2020-07-23,CA,425616,6352688,6778304,06,California
2020-07-23,CO,41698,423713,465411,08,Colorado
2020-07-23,CT,48232,639656,687888,09,Connecticut
2020-07-23,DC,11571,150450,162021,11,District of Columbia
2020-07-23,DE,13924,148427,162351,10,Delaware
2020-07-23,FL,389868,2821074,3210942,12,Florida
2020-07-23,GA,156588,1180350,1336938,13,Georgia
2020-07-23,GU,332,19132,19464,66,Guam
2020-07-23,HI,1435,107378,108813,15,Hawaii
2020-07-23,IA,40634,395652,436286,19,Iowa
2020-07-23,ID,16322,140504,156826,16,Idaho
2020-07-23,IL,168100,2221268,2389368,17,Illinois
2020-07-23,IN,59602,606681,666283,18,Indiana
2020-07-23,KS,24104,244582,268686,20,Kansas
2020-07-23,KY,25147,499648,524795,21,Kentucky
2020-07-23,LA,101650,1073218,1174868,22,Louisiana
2020-07-23,MA,114320,955742,1070062,25,Massachusetts
2020-07-23,MD,80836,708205,789041,24,Maryland
2020-07-23,ME,3737,143938,147675,23,Maine
2020-07-23,MI,84431,1502293,1586724,26,Michigan
2020-07-23,MN,48721,856594,905315,27,Minnesota
2020-07-23,MO,37700,565584,603284,29,Missouri
2020-07-23,MP,38,11300,11338,69,Northern Mariana Islands
2020-07-23,MS,48053,355959,404012,28,Mississippi
2020-07-23,MT,2910,143308,146218,30,Montana
2020-07-23,NC,106893,1416782,1523675,37,North Carolina
2020-07-23,ND,5493,135323,140816,38,North Dakota
2020-07-23,NE,23486,222087,245573,31,Nebraska
2020-07-23,NH,6295,140584,146879,33,New Hampshire
2020-07-23,NJ,177887,1681751,1859638,34,New Jersey
2020-07-23,NM,17828,471506,489334,35,New Mexico
2020-07-23,NV,39919,374217,414136,32,Nevada
2020-07-23,NY,409697,4958641,5368338,36,New York
2020-07-23,OH,80186,1164840,1245026,39,Ohio
2020-07-23,OK,27969,485206,513175,40,Oklahoma
2020-07-23,OR,15713,342778,358491,41,Oregon
2020-07-23,PA,104358,981259,1085617,42,Pennsylvania
2020-07-23,PR,13473,192686,206159,72,Puerto Rico
2020-07-23,RI,18148,171191,189339,44,Rhode Island
2020-07-23,SC,76606,541868,618474,45,South Carolina
2020-07-23,SD,8143,94393,102536,46,South Dakota
2020-07-23,TN,86987,1208998,1295985,47,Tennessee
2020-07-23,TX,361125,2803531,3164656,48,Texas
2020-07-23,UT,36099,449323,485422,49,Utah
2020-07-23,VA,81237,890963,972200,51,Virginia
2020-07-23,VI,336,7500,7836,78,U.S. Virgin Islands
2020-07-23,VT,1377,85205,86582,50,Vermont
2020-07-23,WA,49247,805905,855152,53,Washington
2020-07-23,WI,49669,778842,828511,55,Wisconsin
2020-07-23,WV,5550,245522,251072,54,West Virginia
2020-07-23,WY,2346,45823,48169,56,Wyoming
2020-07-22,AK,2619,182714,185333,02,Alaska
2020-07-22,AL,71813,537675,609488,01,Alabama
2020-07-22,AR,35246,404980,440226,05,Arkansas
2020-07-22,AS,0,1037,1037,60,American Samoa
2020-07-22,AZ,150609,663372,813981,04,Arizona
2020-07-22,CA,413576,6250843,6664419,06,California
2020-07-22,CO,41059,416343,457402,08,Colorado
2020-07-22,CT,48223,626183,674406,09,Connecticut
2020-07-22,DC,11529,148043,159572,11,District of Columbia
2020-07-22,DE,13792,145641,159433,10,Delaware
2020-07-22,FL,379619,2775092,3154711,12,Florida
2020-07-22,GA,152302,1164542,1316844,13,Georgia
2020-07-22,GU,330,18752,19082,66,Guam
2020-07-22,HI,1418,106764,108182,15,Hawaii
2020-07-22,IA,39793,386643,426436,19,Iowa
2020-07-22,ID,15822,138149,153971,16,Idaho
2020-07-22,IL,166476,2183186,2349662,17,Illinois
2020-07-22,IN,58673,595740,654413,18,Indiana
2020-07-22,KS,24104,244582,268686,20,Kansas
2020-07-22,KY,24540,494535,519075,21,Kentucky
2020-07-22,LA,99354,1053547,1152901,22,Louisiana
2020-07-22,MA,114320,955742,1070062,25,Massachusetts
2020-07-22,MD,80172,702661,782833,24,Maryland
2020-07-22,ME,3723,141295,145018,23,Maine
2020-07-22,MI,83730,1475883,1559613,26,Michigan
2020-07-22,MN,47961,840590,888551,27,Minnesota
2020-07-22,MO,36063,553397,589460,29,Missouri
2020-07-22,MP,38,12707,12745,69,Northern Mariana Islands
2020-07-22,MS,47071,355959,403030,28,Mississippi
2020-07-22,MT,2813,140705,143518,30,Montana
2020-07-22,NC,105001,1386819,1491820,37,North Carolina
2020-07-22,ND,5367,133899,139266,38,North Dakota
2020-07-22,NE,23190,219431,242621,31,Nebraska
2020-07-22,NH,6262,139276,145538,33,New Hampshire
2020-07-22,NJ,177645,1663284,1840929,34,New Jersey
2020-07-22,NM,17517,464014,481531,35,New Mexico
2020-07-22,NV,38657,365651,404308,32,Nevada
2020-07-22,NY,408886,4889754,5298640,36,New York
2020-07-22,OH,78742,1142853,1221595,39,Ohio
2020-07-22,OK,27301,478297,505598,40,Oklahoma
2020-07-22,OR,15393,337401,352794,41,Oregon
2020-07-22,PA,103396,968081,1071477,42,Pennsylvania
2020-07-22,PR,13038,192686,205724,72,Puerto Rico
2020-07-22,RI,18062,168794,186856,44,Rhode Island
2020-07-22,SC,75042,534118,609160,45,South Carolina
2020-07-22,SD,8077,92981,101058,46,South Dakota
2020-07-22,TN,84417,1179411,1263828,47,Tennessee
2020-07-22,TX,351618,2752530,3104148,48,Texas
2020-07-22,UT,35578,445824,481402,49,Utah
2020-07-22,VA,80393,873794,954187,51,Virginia
2020-07-22,VI,320,7146,7466,78,U.S. Virgin Islands
2020-07-22,VT,1366,84376,85742,50,Vermont
2020-07-22,WA,48575,792609,841184,53,Washington
2020-07-22,WI,48583,764630,813213,55,Wisconsin
2020-07-22,WV,5206,237181,242387,54,West Virginia
2020-07-22,WY,2288,41927,44215,56,Wyoming
2020-07-21,AK,2525,176101,178626,02,Alaska
2020-07-21,AL,70358,530023,600381,01,Alabama
2020-07-21,AR,34655,404980,439635,05,Arkansas
2020-07-21,AS,0,1037,1037,60,American Samoa
2020-07-21,AZ,148683,658983,807666,04,Arizona
2020-07-21,CA,400769,6136163,6536932,06,California
2020-07-21,CO,40566,410733,451299,08,Colorado
2020-07-21,CT,48096,614741,662837,09,Connecticut
2020-07-21,DC,11427,144284,155711,11,District of Columbia
2020-07-21,DE,13746,144601,158347,10,Delaware
2020-07-21,FL,369834,2729916,3099750,12,Florida
2020-07-21,GA,148988,1146303,1295291,13,Georgia
2020-07-21,GU,327,18430,18757,66,Guam
2020-07-21,HI,1393,105390,106783,15,Hawaii
2020-07-21,IA,39474,382959,422433,19,Iowa
2020-07-21,ID,15266,135805,151071,16,Idaho
2020-07-21,IL,164878,2145151,2310029,17,Illinois
2020-07-21,IN,57916,586889,644805,18,Indiana
2020-07-21,KS,23334,238197,261531,20,Kansas
2020-07-21,KY,24060,484633,508693,21,Kentucky
2020-07-21,LA,96583,1026379,1122962,22,Louisiana
2020-07-21,MA,114033,945148,1059181,25,Massachusetts
2020-07-21,MD,79545,684822,764367,24,Maryland
2020-07-21,ME,3723,138520,142243,23,Maine
2020-07-21,MI,83059,1446316,1529375,26,Michigan
2020-07-21,MN,47457,829402,876859,27,Minnesota
2020-07-21,MO,34762,545558,580320,29,Missouri
2020-07-21,MP,38,11055,11093,69,Northern Mariana Islands
2020-07-21,MS,45524,349674,395198,28,Mississippi
2020-07-21,MT,2712,138290,141002,30,Montana
2020-07-21,NC,102861,1356136,1458997,37,North Carolina
2020-07-21,ND,5207,132086,137293,38,North Dakota
2020-07-21,NE,22847,215594,238441,31,Nebraska
2020-07-21,NH,6249,138573,144822,33,New Hampshire
2020-07-21,NJ,177256,1640699,1817955,34,New Jersey
2020-07-21,NM,17215,459282,476497,35,New Mexico
2020-07-21,NV,37528,361294,398822,32,Nevada
2020-07-21,NY,408181,4822800,5230981,36,New York
2020-07-21,OH,77215,1122808,1200023,39,Ohio
2020-07-21,OK,25433,472057,497490,40,Oklahoma
2020-07-21,OR,15139,330124,345263,41,Oregon
2020-07-21,PA,102765,952998,1055763,42,Pennsylvania
2020-07-21,PR,12940,192686,205626,72,Puerto Rico
2020-07-21,RI,17986,166978,184964,44,Rhode Island
2020-07-21,SC,73337,525356,598693,45,South Carolina
2020-07-21,SD,8019,91826,99845,46,South Dakota
2020-07-21,TN,81944,1156289,1238233,47,Tennessee
2020-07-21,TX,341739,2701835,3043574,48,Texas
2020-07-21,UT,35012,440431,475443,49,Utah
2020-07-21,VA,79371,860721,940092,51,Virginia
2020-07-21,VI,308,6853,7161,78,U.S. Virgin Islands
2020-07-21,VT,1366,83581,84947,50,Vermont
2020-07-21,WA,47743,778611,826354,53,Washington
2020-07-21,WI,47836,750562,798398,55,Wisconsin
2020-07-21,WV,5199,235127,240326,54,West Virginia
2020-07-21,WY,2238,41927,44165,56,Wyoming
2020-07-20,AK,2414,173172,175586,02,Alaska
2020-07-20,AL,68891,524897,593788,01,Alabama
2020-07-20,AR,33927,398889,432816,05,Arkansas
2020-07-20,AS,0,1037,1037,60,American Samoa
2020-07-20,AZ,145183,648340,793523,04,Arizona
2020-07-20,CA,391538,6022783,6414321,06,California
2020-07-20,CO,40142,402027,442169,08,Colorado
2020-07-20,CT,48055,614741,662796,09,Connecticut
2020-07-20,DC,11339,140401,151740,11,District of Columbia
2020-07-20,DE,13519,139476,152995,10,Delaware
2020-07-20,FL,360394,2691712,3052106,12,Florida
2020-07-20,GA,145575,1128206,1273781,13,Georgia
2020-07-20,GU,319,18252,18571,66,Guam
2020-07-20,HI,1381,104575,105956,15,Hawaii
2020-07-20,IA,39166,379378,418544,19,Iowa
2020-07-20,ID,14873,133015,147888,16,Idaho
2020-07-20,IL,163923,2116361,2280284,17,Illinois
2020-07-20,IN,57206,578454,635660,18,Indiana
2020-07-20,KS,23334,238197,261531,20,Kansas
2020-07-20,KY,23414,470740,494154,21,Kentucky
2020-07-20,LA,94892,1008032,1102924,22,Louisiana
2020-07-20,MA,113789,937492,1051281,25,Massachusetts
2020-07-20,MD,78685,670594,749279,24,Maryland
2020-07-20,ME,3711,135511,139222,23,Maine
2020-07-20,MI,82395,1424394,1506789,26,Michigan
2020-07-20,MN,47107,820303,867410,27,Minnesota
2020-07-20,MO,33624,538288,571912,29,Missouri
2020-07-20,MP,37,11055,11092,69,Northern Mariana Islands
2020-07-20,MS,43889,346086,389975,28,Mississippi
2020-07-20,MT,2621,136421,139042,30,Montana
2020-07-20,NC,101046,1322842,1423888,37,North Carolina
2020-07-20,ND,5126,130852,135978,38,North Dakota
2020-07-20,NE,22583,212313,234896,31,Nebraska
2020-07-20,NH,6203,137175,143378,33,New Hampshire
2020-07-20,NJ,176963,1625911,1802874,34,New Jersey
2020-07-20,NM,16971,452244,469215,35,New Mexico
2020-07-20,NV,36713,358708,395421,32,Nevada
2020-07-20,NY,407326,4757486,5164812,36,New York
2020-07-20,OH,76168,1105744,1181912,39,Ohio
2020-07-20,OK,25433,450675,476108,40,Oklahoma
2020-07-20,OR,14847,325197,340044,41,Oregon
2020-07-20,PA,101738,938175,1039913,42,Pennsylvania
2020-07-20,PR,12461,192686,205147,72,Puerto Rico
2020-07-20,RI,17904,165721,183625,44,Rhode Island
2020-07-20,SC,71445,516871,588316,45,South Carolina
2020-07-20,SD,7943,90711,98654,46,South Dakota
2020-07-20,TN,79754,1135413,1215167,47,Tennessee
2020-07-20,TX,332434,2652120,2984554,48,Texas
2020-07-20,UT,34526,434878,469404,49,Utah
2020-07-20,VA,78375,842086,920461,51,Virginia
2020-07-20,VI,304,6617,6921,78,U.S. Virgin Islands
2020-07-20,VT,1360,82508,83868,50,Vermont
2020-07-20,WA,46946,762393,809339,53,Washington
2020-07-20,WI,46675,737191,783866,55,Wisconsin
2020-07-20,WV,5142,229838,234980,54,West Virginia
2020-07-20,WY,2187,41927,44114,56,Wyoming
2020-07-19,AK,2277,170733,173010,02,Alaska
2020-07-19,AL,67011,518522,585533,01,Alabama
2020-07-19,AR,32533,386638,419171,05,Arkansas
2020-07-19,AS,0,1037,1037,60,American Samoa
2020-07-19,AZ,143624,642355,785979,04,Arizona
2020-07-19,CA,384692,5902160,6286852,06,California
2020-07-19,CO,39788,396150,435938,08,Colorado
2020-07-19,CT,47893,609238,657131,09,Connecticut
2020-07-19,DC,11261,136504,147765,11,District of Columbia
2020-07-19,DE,13519,139476,152995,10,Delaware
2020-07-19,FL,350047,2652594,3002641,12,Florida
2020-07-19,GA,143123,1112196,1255319,13,Georgia
2020-07-19,GU,315,17938,18253,66,Guam
2020-07-19,HI,1354,103281,104635,15,Hawaii
2020-07-19,IA,38723,376768,415491,19,Iowa
2020-07-19,ID,14302,131884,146186,16,Idaho
2020-07-19,IL,162750,2082936,2245686,17,Illinois
2020-07-19,IN,56571,570309,626880,18,Indiana
2020-07-19,KS,21965,227388,249353,20,Kansas
2020-07-19,KY,23161,469563,492724,21,Kentucky
2020-07-19,LA,91706,977598,1069304,22,Louisiana
2020-07-19,MA,113534,927001,1040535,25,Massachusetts
2020-07-19,MD,78131,661654,739785,24,Maryland
2020-07-19,ME,3687,133750,137437,23,Maine
2020-07-19,MI,81868,1402591,1484459,26,Michigan
2020-07-19,MN,46204,806984,853188,27,Minnesota
2020-07-19,MO,33094,525985,559079,29,Missouri
2020-07-19,MP,37,10664,10701,69,Northern Mariana Islands
2020-07-19,MS,42638,335439,378077,28,Mississippi
2020-07-19,MT,2533,130626,133159,30,Montana
2020-07-19,NC,99778,1295086,1394864,37,North Carolina
2020-07-19,ND,5019,128835,133854,38,North Dakota
2020-07-19,NE,22481,209920,232401,31,Nebraska
2020-07-19,NH,6203,137175,143378,33,New Hampshire
2020-07-19,NJ,176783,1614354,1791137,34,New Jersey
2020-07-19,NM,16736,443928,460664,35,New Mexico
2020-07-19,NV,35765,354023,389788,32,Nevada
2020-07-19,NY,406807,4708663,5115470,36,New York
2020-07-19,OH,74932,1087982,1162914,39,Ohio
2020-07-19,OK,25265,450675,475940,40,Oklahoma
2020-07-19,OR,14579,321011,335590,41,Oregon
2020-07-19,PA,101027,926352,1027379,42,Pennsylvania
2020-07-19,PR,12063,192686,204749,72,Puerto Rico
2020-07-19,RI,17793,161408,179201,44,Rhode Island
2020-07-19,SC,69986,507400,577386,45,South Carolina
2020-07-19,SD,7906,90181,98087,46,South Dakota
2020-07-19,TN,78115,1119182,1197297,47,Tennessee
2020-07-19,TX,325030,2607334,2932364,48,Texas
2020-07-19,UT,34117,428705,462822,49,Utah
2020-07-19,VA,77430,829933,907363,51,Virginia
2020-07-19,VI,297,6587,6884,78,U.S. Virgin Islands
2020-07-19,VT,1350,81150,82500,50,Vermont
2020-07-19,WA,46026,745760,791786,53,Washington
2020-07-19,WI,45948,730902,776850,55,Wisconsin
2020-07-19,WV,5042,225946,230988,54,West Virginia
2020-07-19,WY,2126,41927,44053,56,Wyoming
2020-07-18,AK,2159,166204,168363,02,Alaska
2020-07-18,AL,65234,509261,574495,01,Alabama
2020-07-18,AR,31762,381243,413005,05,Arkansas
2020-07-18,AS,0,1037,1037,60,American Samoa
2020-07-18,AZ,141265,630726,771991,04,Arizona
2020-07-18,CA,375363,5791855,6167218,06,California
2020-07-18,CO,39344,391439,430783,08,Colorado
2020-07-18,CT,47893,582076,629969,09,Connecticut
2020-07-18,DC,11194,133761,144955,11,District of Columbia
2020-07-18,DE,13429,137328,150757,10,Delaware
2020-07-18,FL,337569,2594419,2931988,12,Florida
2020-07-18,GA,139872,1091934,1231806,13,Georgia
2020-07-18,GU,315,17938,18253,66,Guam
2020-07-18,HI,1334,101661,102995,15,Hawaii
2020-07-18,IA,37907,365822,403729,19,Iowa
2020-07-18,ID,13752,128753,142505,16,Idaho
2020-07-18,IL,161785,2051788,2213573,17,Illinois
2020-07-18,IN,55654,558801,614455,18,Indiana
2020-07-18,KS,21965,227388,249353,20,Kansas
2020-07-18,KY,22184,468017,490201,21,Kentucky
2020-07-18,LA,88590,955350,1043940,22,Louisiana
2020-07-18,MA,113238,913595,1026833,25,Massachusetts
2020-07-18,MD,77206,643780,720986,24,Maryland
2020-07-18,ME,3646,131283,134929,23,Maine
2020-07-18,MI,81338,1374740,1456078,26,Michigan
2020-07-18,MN,45470,790492,835962,27,Minnesota
2020-07-18,MO,32248,518628,550876,29,Missouri
2020-07-18,MP,37,10664,10701,69,Northern Mariana Islands
2020-07-18,MS,41846,335439,377285,28,Mississippi
2020-07-18,MT,2471,129408,131879,30,Montana
2020-07-18,NC,97958,1281185,1379143,37,North Carolina
2020-07-18,ND,4907,126608,131515,38,North Dakota
2020-07-18,NE,22361,208790,231151,31,Nebraska
2020-07-18,NH,6165,135621,141786,33,New Hampshire
2020-07-18,NJ,176814,1604636,1781450,34,New Jersey
2020-07-18,NM,16456,435842,452298,35,New Mexico
2020-07-18,NV,34477,348060,382537,32,Nevada
2020-07-18,NY,406305,4662961,5069266,36,New York
2020-07-18,OH,73822,1064614,1138436,39,Ohio
2020-07-18,OK,25056,450675,475731,40,Oklahoma
2020-07-18,OR,14149,316644,330793,41,Oregon
2020-07-18,PA,100241,912486,1012727,42,Pennsylvania
2020-07-18,PR,11453,192686,204139,72,Puerto Rico
2020-07-18,RI,17793,161408,179201,44,Rhode Island
2020-07-18,SC,67612,494381,561993,45,South Carolina
2020-07-18,SD,7862,89385,97247,46,South Dakota
2020-07-18,TN,76336,1097316,1173652,47,Tennessee
2020-07-18,TX,317730,2524955,2842685,48,Texas
2020-07-18,UT,33332,422908,456240,49,Utah
2020-07-18,VA,76373,813328,889701,51,Virginia
2020-07-18,VI,283,6239,6522,78,U.S. Virgin Islands
2020-07-18,VT,1338,79108,80446,50,Vermont
2020-07-18,WA,45067,722590,767657,53,Washington
2020-07-18,WI,45099,723643,768742,55,Wisconsin
2020-07-18,WV,4894,220617,225511,54,West Virginia
2020-07-18,WY,2108,41927,44035,56,Wyoming
2020-07-17,AK,2081,163333,165414,02,Alaska
2020-07-17,AL,63091,500024,563115,01,Alabama
2020-07-17,AR,31762,375735,407497,05,Arkansas
2020-07-17,AS,0,1037,1037,60,American Samoa
2020-07-17,AZ,138523,626445,764968,04,Arizona
2020-07-17,CA,366164,5677935,6044099,06,California
2020-07-17,CO,38726,385623,424349,08,Colorado
2020-07-17,CT,47893,582215,630108,09,Connecticut
2020-07-17,DC,11115,130492,141607,11,District of Columbia
2020-07-17,DE,13337,135273,148610,10,Delaware
2020-07-17,FL,327241,2553527,2880768,12,Florida
2020-07-17,GA,135183,1063495,1198678,13,Georgia
2020-07-17,GU,314,17938,18252,66,Guam
2020-07-17,HI,1311,99893,101204,15,Hawaii
2020-07-17,IA,37722,364731,402453,19,Iowa
2020-07-17,ID,13133,127186,140319,16,Idaho
2020-07-17,IL,160509,2006965,2167474,17,Illinois
2020-07-17,IN,54813,549822,604635,18,Indiana
2020-07-17,KS,21965,227388,249353,20,Kansas
2020-07-17,KY,21605,461457,483062,21,Kentucky
2020-07-17,LA,88590,955350,1043940,22,Louisiana
2020-07-17,MA,112879,901708,1014587,25,Massachusetts
2020-07-17,MD,76371,631845,708216,24,Maryland
2020-07-17,ME,3636,129809,133445,23,Maine
2020-07-17,MI,80593,1344913,1425506,26,Michigan
2020-07-17,MN,45013,774498,819511,27,Minnesota
2020-07-17,MO,31288,506608,537896,29,Missouri
2020-07-17,MP,37,10664,10701,69,Northern Mariana Islands
2020-07-17,MS,40829,330635,371464,28,Mississippi
2020-07-17,MT,2366,128038,130404,30,Montana
2020-07-17,NC,95477,1248497,1343974,37,North Carolina
2020-07-17,ND,4792,124683,129475,38,North Dakota
2020-07-17,NE,22134,204062,226196,31,Nebraska
2020-07-17,NH,6165,135621,141786,33,New Hampshire
2020-07-17,NJ,176551,1592377,1768928,34,New Jersey
2020-07-17,NM,16138,427230,443368,35,New Mexico
2020-07-17,NV,33295,343712,377007,32,Nevada
2020-07-17,NY,405551,4593898,4999449,36,New York
2020-07-17,OH,72280,1043844,1116124,39,Ohio
2020-07-17,OK,24140,440904,465044,40,Oklahoma
2020-07-17,OR,13802,310393,324195,41,Oregon
2020-07-17,PA,99478,899912,999390,42,Pennsylvania
2020-07-17,PR,11120,192686,203806,72,Puerto Rico
2020-07-17,RI,17793,161408,179201,44,Rhode Island
2020-07-17,SC,66060,487315,553375,45,South Carolina
2020-07-17,SD,7789,88184,95973,46,South Dakota
2020-07-17,TN,73819,1076853,1150672,47,Tennessee
2020-07-17,TX,307572,2459749,2767321,48,Texas
2020-07-17,UT,32572,415234,447806,49,Utah
2020-07-17,VA,75433,801271,876704,51,Virginia
2020-07-17,VI,263,5790,6053,78,U.S. Virgin Islands
2020-07-17,VT,1334,78032,79366,50,Vermont
2020-07-17,WA,44313,708861,753174,53,Washington
2020-07-17,WI,44068,712197,756265,55,Wisconsin
2020-07-17,WV,4783,217769,222552,54,West Virginia
2020-07-17,WY,2069,41927,43996,56,Wyoming
2020-07-16,AK,2032,160990,163022,02,Alaska
2020-07-16,AL,61088,490021,551109,01,Alabama
2020-07-16,AR,31114,369847,400961,05,Arkansas
2020-07-16,AS,0,1037,1037,60,American Samoa
2020-07-16,AZ,134613,614653,749266,04,Arizona
2020-07-16,CA,356178,5559330,5915508,06,California
2020-07-16,CO,38155,378061,416216,08,Colorado
2020-07-16,CT,47750,582333,630083,09,Connecticut
2020-07-16,DC,11076,129166,140242,11,District of Columbia
2020-07-16,DE,13114,131756,144870,10,Delaware
2020-07-16,FL,315775,2499843,2815618,12,Florida
2020-07-16,GA,131275,1046947,1178222,13,Georgia
2020-07-16,GU,314,17697,18011,66,Guam
2020-07-16,HI,1292,98095,99387,15,Hawaii
2020-07-16,IA,37132,359319,396451,19,Iowa
2020-07-16,ID,12445,124418,136863,16,Idaho
2020-07-16,IL,159082,1964657,2123739,17,Illinois
2020-07-16,IN,54080,541478,595558,18,Indiana
2020-07-16,KS,20933,218441,239374,20,Kansas
2020-07-16,KY,21083,446921,468004,21,Kentucky
2020-07-16,LA,86411,937726,1024137,22,Louisiana
2020-07-16,MA,112581,889103,1001684,25,Massachusetts
2020-07-16,MD,75664,616865,692529,24,Maryland
2020-07-16,ME,3598,126864,130462,23,Maine
2020-07-16,MI,79839,1315315,1395154,26,Michigan
2020-07-16,MN,44347,760865,805212,27,Minnesota
2020-07-16,MO,30422,498879,529301,29,Missouri
2020-07-16,MP,36,10664,10700,69,Northern Mariana Islands
2020-07-16,MS,39797,324103,363900,28,Mississippi
2020-07-16,MT,2231,125609,127840,30,Montana
2020-07-16,NC,93426,1219331,1312757,37,North Carolina
2020-07-16,ND,4668,123388,128056,38,North Dakota
2020-07-16,NE,21979,201250,223229,31,Nebraska
2020-07-16,NH,6113,132159,138272,33,New Hampshire
2020-07-16,NJ,176501,1583403,1759904,34,New Jersey
2020-07-16,NM,15841,421164,437005,35,New Mexico
2020-07-16,NV,31915,338928,370843,32,Nevada
2020-07-16,NY,404775,4516435,4921210,36,New York
2020-07-16,OH,70601,1018192,1088793,39,Ohio
2020-07-16,OK,23441,433376,456817,40,Oklahoma
2020-07-16,OR,13509,305437,318946,41,Oregon
2020-07-16,PA,98446,885195,983641,42,Pennsylvania
2020-07-16,PR,10574,192686,203260,72,Puerto Rico
2020-07-16,RI,17711,159677,177388,44,Rhode Island
2020-07-16,SC,64083,475881,539964,45,South Carolina
2020-07-16,SD,7694,86342,94036,46,South Dakota
2020-07-16,TN,71540,1052157,1123697,47,Tennessee
2020-07-16,TX,292656,2407199,2699855,48,Texas
2020-07-16,UT,31845,407683,439528,49,Utah
2020-07-16,VA,74431,786742,861173,51,Virginia
2020-07-16,VI,249,5036,5285,78,U.S. Virgin Islands
2020-07-16,VT,1325,77715,79040,50,Vermont
2020-07-16,WA,43046,690840,733886,53,Washington
2020-07-16,WI,43139,699670,742809,55,Wisconsin
2020-07-16,WV,4657,214517,219174,54,West Virginia
2020-07-16,WY,2026,41426,43452,56,Wyoming
2020-07-15,AK,1631,154462,156093,02,Alaska
2020-07-15,AL,59067,481982,541049,01,Alabama
2020-07-15,AR,30297,365479,395776,05,Arkansas
2020-07-15,AS,0,816,816,60,American Samoa
2020-07-15,AZ,131354,604608,735962,04,Arizona
2020-07-15,CA,347634,5445642,5793276,06,California
2020-07-15,CO,37686,372304,409990,08,Colorado
2020-07-15,CT,47636,568022,615658,09,Connecticut
2020-07-15,DC,11026,126918,137944,11,District of Columbia
2020-07-15,DE,13050,130338,143388,10,Delaware
2020-07-15,FL,301810,2434143,2735953,12,Florida
2020-07-15,GA,127834,1027149,1154983,13,Georgia
2020-07-15,GU,313,17514,17827,66,Guam
2020-07-15,HI,1264,96293,97557,15,Hawaii
2020-07-15,IA,36291,351021,387312,19,Iowa
2020-07-15,ID,11718,122196,133914,16,Idaho
2020-07-15,IL,157825,1922908,2080733,17,Illinois
2020-07-15,IN,53370,533219,586589,18,Indiana
2020-07-15,KS,20933,218441,239374,20,Kansas
2020-07-15,KY,20677,438510,459187,21,Kentucky
2020-07-15,LA,84131,917069,1001200,22,Louisiana
2020-07-15,MA,112347,876366,988713,25,Massachusetts
2020-07-15,MD,75016,605072,680088,24,Maryland
2020-07-15,ME,3578,124353,127931,23,Maine
2020-07-15,MI,78913,1289006,1367919,26,Michigan
2020-07-15,MN,43742,746755,790497,27,Minnesota
2020-07-15,MO,29714,488233,517947,29,Missouri
2020-07-15,MP,36,10664,10700,69,Northern Mariana Islands
2020-07-15,MS,38567,318290,356857,28,Mississippi
2020-07-15,MT,2096,121662,123758,30,Montana
2020-07-15,NC,91266,1193371,1284637,37,North Carolina
2020-07-15,ND,4565,121999,126564,38,North Dakota
2020-07-15,NE,21717,198026,219743,31,Nebraska
2020-07-15,NH,6091,131018,137109,33,New Hampshire
2020-07-15,NJ,176278,1566069,1742347,34,New Jersey
2020-07-15,NM,15514,414492,430006,35,New Mexico
2020-07-15,NV,30468,333957,364425,32,Nevada
2020-07-15,NY,404006,4444519,4848525,36,New York
2020-07-15,OH,69311,993312,1062623,39,Ohio
2020-07-15,OK,22813,424512,447325,40,Oklahoma
2020-07-15,OR,13081,298705,311786,41,Oregon
2020-07-15,PA,97665,870984,968649,42,Pennsylvania
2020-07-15,PR,10379,192686,203065,72,Puerto Rico
2020-07-15,RI,17640,158235,175875,44,Rhode Island
2020-07-15,SC,62245,463738,525983,45,South Carolina
2020-07-15,SD,7652,85891,93543,46,South Dakota
2020-07-15,TN,69061,1028612,1097673,47,Tennessee
2020-07-15,TX,282365,2359834,2642199,48,Texas
2020-07-15,UT,30891,401189,432080,49,Utah
2020-07-15,VA,73527,771455,844982,51,Virginia
2020-07-15,VI,243,4637,4880,78,U.S. Virgin Islands
2020-07-15,VT,1318,77040,78358,50,Vermont
2020-07-15,WA,42304,675930,718234,53,Washington
2020-07-15,WI,42197,686299,728496,55,Wisconsin
2020-07-15,WV,4557,213347,217904,54,West Virginia
2020-07-15,WY,1985,40929,42914,56,Wyoming
2020-07-14,AK,1579,147894,149473,02,Alaska
2020-07-14,AL,57255,471834,529089,01,Alabama
2020-07-14,AR,29733,360566,390299,05,Arkansas
2020-07-14,AS,0,816,816,60,American Samoa
2020-07-14,AZ,128097,593846,721943,04,Arizona
2020-07-14,CA,336508,5338447,5674955,06,California
2020-07-14,CO,37242,367713,404955,08,Colorado
2020-07-14,CT,47530,556593,604123,09,Connecticut
2020-07-14,DC,10946,122970,133916,11,District of Columbia
2020-07-14,DE,12969,128631,141600,10,Delaware
2020-07-14,FL,291629,2393614,2685243,12,Florida
2020-07-14,GA,123963,1007071,1131034,13,Georgia
2020-07-14,GU,312,17225,17537,66,Guam
2020-07-14,HI,1243,94827,96070,15,Hawaii
2020-07-14,IA,35849,344559,380408,19,Iowa
2020-07-14,ID,11402,118882,130284,16,Idaho
2020-07-14,IL,156638,1885934,2042572,17,Illinois
2020-07-14,IN,52685,525724,578409,18,Indiana
2020-07-14,KS,20058,211117,231175,20,Kansas
2020-07-14,KY,20223,435333,455556,21,Kentucky
2020-07-14,LA,82042,894413,976455,22,Louisiana
2020-07-14,MA,112130,866084,978214,25,Massachusetts
2020-07-14,MD,74260,591809,666069,24,Maryland
2020-07-14,ME,3566,121909,125475,23,Maine
2020-07-14,MI,77864,1255922,1333786,26,Michigan
2020-07-14,MN,43170,734444,777614,27,Minnesota
2020-07-14,MO,28826,476277,505103,29,Missouri
2020-07-14,MP,33,10664,10697,69,Northern Mariana Islands
2020-07-14,MS,37542,312671,350213,28,Mississippi
2020-07-14,MT,1952,119444,121396,30,Montana
2020-07-14,NC,89484,1165362,1254846,37,North Carolina
2020-07-14,ND,4493,120540,125033,38,North Dakota
2020-07-14,NE,21399,194836,216235,31,Nebraska
2020-07-14,NH,6068,129960,136028,33,New Hampshire
2020-07-14,NJ,175915,1545316,1721231,34,New Jersey
2020-07-14,NM,15291,409064,424355,35,New Mexico
2020-07-14,NV,29619,330561,360180,32,Nevada
2020-07-14,NY,403175,4381752,4784927,36,New York
2020-07-14,OH,67995,975754,1043749,39,Ohio
2020-07-14,OK,21738,419556,441294,40,Oklahoma
2020-07-14,OR,12805,292651,305456,41,Oregon
2020-07-14,PA,96671,850612,947283,42,Pennsylvania
2020-07-14,PR,10123,192686,202809,72,Puerto Rico
2020-07-14,RI,17588,157070,174658,44,Rhode Island
2020-07-14,SC,60389,457092,517481,45,South Carolina
2020-07-14,SD,7572,84592,92164,46,South Dakota
2020-07-14,TN,66788,1005100,1071888,47,Tennessee
2020-07-14,TX,275058,2323622,2598680,48,Texas
2020-07-14,UT,30478,394043,424521,49,Utah
2020-07-14,VA,72443,758407,830850,51,Virginia
2020-07-14,VI,206,4084,4290,78,U.S. Virgin Islands
2020-07-14,VT,1305,76319,77624,50,Vermont
2020-07-14,WA,41757,666517,708274,53,Washington
2020-07-14,WI,41349,673195,714544,55,Wisconsin
2020-07-14,WV,4407,209605,214012,54,West Virginia
2020-07-14,WY,1951,38077,40028,56,Wyoming
2020-07-13,AK,1539,145051,146590,02,Alaska
2020-07-13,AL,55545,464059,519604,01,Alabama
2020-07-13,AR,28939,354035,382974,05,Arkansas
2020-07-13,AS,0,816,816,60,American Samoa
2020-07-13,AZ,123824,578602,702426,04,Arizona
2020-07-13,CA,329162,5215203,5544365,06,California
2020-07-13,CO,36913,362452,399365,08,Colorado
2020-07-13,CT,47510,544470,591980,09,Connecticut
2020-07-13,DC,10906,119314,130220,11,District of Columbia
2020-07-13,DE,12879,126484,139363,10,Delaware
2020-07-13,FL,282435,2357139,2639574,12,Florida
2020-07-13,GA,120569,987398,1107967,13,Georgia
2020-07-13,GU,312,17030,17342,66,Guam
2020-07-13,HI,1220,93950,95170,15,Hawaii
2020-07-13,IA,35529,341187,376716,19,Iowa
2020-07-13,ID,10902,116230,127132,16,Idaho
2020-07-13,IL,155931,1858195,2014126,17,Illinois
2020-07-13,IN,52037,518372,570409,18,Indiana
2020-07-13,KS,20058,211117,231175,20,Kansas
2020-07-13,KY,19653,422232,441885,21,Kentucky
2020-07-13,LA,79827,873599,953426,22,Louisiana
2020-07-13,MA,111827,854316,966143,25,Massachusetts
2020-07-13,MD,73527,578430,651957,24,Maryland
2020-07-13,ME,3558,120404,123962,23,Maine
2020-07-13,MI,77198,1236229,1313427,26,Michigan
2020-07-13,MN,42772,726217,768989,27,Minnesota
2020-07-13,MO,27890,467887,495777,29,Missouri
2020-07-13,MP,33,10734,10767,69,Northern Mariana Islands
2020-07-13,MS,36680,306735,343415,28,Mississippi
2020-07-13,MT,1843,116852,118695,30,Montana
2020-07-13,NC,87528,1132958,1220486,37,North Carolina
2020-07-13,ND,4442,119436,123878,38,North Dakota
2020-07-13,NE,21172,190487,211659,31,Nebraska
2020-07-13,NH,6054,128812,134866,33,New Hampshire
2020-07-13,NJ,175522,1524863,1700385,34,New Jersey
2020-07-13,NM,15028,403329,418357,35,New Mexico
2020-07-13,NV,28515,324678,353193,32,Nevada
2020-07-13,NY,402263,4322619,4724882,36,New York
2020-07-13,OH,66853,957898,1024751,39,Ohio
2020-07-13,OK,20745,400037,420782,40,Oklahoma
2020-07-13,OR,12438,288274,300712,41,Oregon
2020-07-13,PA,95742,835732,931474,42,Pennsylvania
2020-07-13,PR,10010,192686,202696,72,Puerto Rico
2020-07-13,RI,17487,155756,173243,44,Rhode Island
2020-07-13,SC,58168,448933,507101,45,South Carolina
2020-07-13,SD,7524,83854,91378,46,South Dakota
2020-07-13,TN,65274,988687,1053961,47,Tennessee
2020-07-13,TX,264313,2275812,2540125,48,Texas
2020-07-13,UT,30030,388305,418335,49,Utah
2020-07-13,VA,71642,742373,814015,51,Virginia
2020-07-13,VI,206,4084,4290,78,U.S. Virgin Islands
2020-07-13,VT,1301,75280,76581,50,Vermont
2020-07-13,WA,40656,645349,686005,53,Washington
2020-07-13,WI,40382,659479,699861,55,Wisconsin
2020-07-13,WV,4259,203966,208225,54,West Virginia
2020-07-13,WY,1862,38077,39939,56,Wyoming
2020-07-12,AK,1479,143996,145475,02,Alaska
2020-07-12,AL,53587,457919,511506,01,Alabama
2020-07-12,AR,28367,354035,382402,05,Arkansas
2020-07-12,AS,0,816,816,60,American Samoa
2020-07-12,AZ,122467,573705,696172,04,Arizona
2020-07-12,CA,320804,5085795,5406599,06,California
2020-07-12,CO,36591,355512,392103,08,Colorado
2020-07-12,CT,47287,542107,589394,09,Connecticut
2020-07-12,DC,10847,116036,126883,11,District of Columbia
2020-07-12,DE,12804,124605,137409,10,Delaware
2020-07-12,FL,269811,2304196,2574007,12,Florida
2020-07-12,GA,116926,966490,1083416,13,Georgia
2020-07-12,GU,312,16667,16979,66,Guam
2020-07-12,HI,1200,92720,93920,15,Hawaii
2020-07-12,IA,35071,339342,374413,19,Iowa
2020-07-12,ID,10505,114756,125261,16,Idaho
2020-07-12,IL,155048,1829066,1984114,17,Illinois
2020-07-12,IN,51612,513035,564647,18,Indiana
2020-07-12,KS,18611,199168,217779,20,Kansas
2020-07-12,KY,19389,418781,438170,21,Kentucky
2020-07-12,LA,78122,856873,934995,22,Louisiana
2020-07-12,MA,111597,845883,957480,25,Massachusetts
2020-07-12,MD,73109,570282,643391,24,Maryland
2020-07-12,ME,3539,118775,122314,23,Maine
2020-07-12,MI,76776,1219379,1296155,26,Michigan
2020-07-12,MN,42281,712771,755052,27,Minnesota
2020-07-12,MO,27443,458065,485508,29,Missouri
2020-07-12,MP,33,10734,10767,69,Northern Mariana Islands
2020-07-12,MS,36287,298924,335211,28,Mississippi
2020-07-12,MT,1758,112903,114661,30,Montana
2020-07-12,NC,85701,1113874,1199575,37,North Carolina
2020-07-12,ND,4334,118145,122479,38,North Dakota
2020-07-12,NE,20998,187105,208103,31,Nebraska
2020-07-12,NH,6024,127365,133389,33,New Hampshire
2020-07-12,NJ,175298,1510306,1685604,34,New Jersey
2020-07-12,NM,14773,395981,410754,35,New Mexico
2020-07-12,NV,27683,319873,347556,32,Nevada
2020-07-12,NY,401706,4271489,4673195,36,New York
2020-07-12,OH,65592,940794,1006386,39,Ohio
2020-07-12,OK,20235,400037,420272,40,Oklahoma
2020-07-12,OR,12170,284002,296172,41,Oregon
2020-07-12,PA,95266,829018,924284,42,Pennsylvania
2020-07-12,PR,9654,192686,202340,72,Puerto Rico
2020-07-12,RI,17312,149343,166655,44,Rhode Island
2020-07-12,SC,56648,435860,492508,45,South Carolina
2020-07-12,SD,7499,83109,90608,46,South Dakota
2020-07-12,TN,61960,956055,1018015,47,Tennessee
2020-07-12,TX,258658,2234096,2492754,48,Texas
2020-07-12,UT,29484,383574,413058,49,Utah
2020-07-12,VA,70670,733375,804045,51,Virginia
2020-07-12,VI,181,3908,4089,78,U.S. Virgin Islands
2020-07-12,VT,1296,74555,75851,50,Vermont
2020-07-12,WA,39218,629248,668466,53,Washington
2020-07-12,WI,39877,653352,693229,55,Wisconsin
2020-07-12,WV,4207,202829,207036,54,West Virginia
2020-07-12,WY,1862,38077,39939,56,Wyoming
2020-07-11,AK,1385,141991,143376,02,Alaska
2020-07-11,AL,51947,450073,502020,01,Alabama
2020-07-11,AR,26803,342846,369649,05,Arkansas
2020-07-11,AS,0,816,816,60,American Samoa
2020-07-11,AZ,119930,564060,683990,04,Arizona
2020-07-11,CA,312344,4963351,5275695,06,California
2020-07-11,CO,36191,349670,385861,08,Colorado
2020-07-11,CT,47287,511101,558388,09,Connecticut
2020-07-11,DC,10801,113249,124050,11,District of Columbia
2020-07-11,DE,12743,121372,134115,10,Delaware
2020-07-11,FL,254511,2220788,2475299,12,Florida
2020-07-11,GA,114401,950472,1064873,13,Georgia
2020-07-11,GU,312,16667,16979,66,Guam
2020-07-11,HI,1158,91076,92234,15,Hawaii
2020-07-11,IA,34647,333714,368361,19,Iowa
2020-07-11,ID,9928,112421,122349,16,Idaho
2020-07-11,IL,154094,1791126,1945220,17,Illinois
2020-07-11,IN,51079,507067,558146,18,Indiana
2020-07-11,KS,18611,199168,217779,20,Kansas
2020-07-11,KY,19121,418781,437902,21,Kentucky
2020-07-11,LA,76803,847644,924447,22,Louisiana
2020-07-11,MA,111398,834936,946334,25,Massachusetts
2020-07-11,MD,72467,556810,629277,24,Maryland
2020-07-11,ME,3520,116370,119890,23,Maine
2020-07-11,MI,76370,1197752,1274122,26,Michigan
2020-07-11,MN,41571,700524,742095,27,Minnesota
2020-07-11,MO,27133,447417,474550,29,Missouri
2020-07-11,MP,31,10734,10765,69,Northern Mariana Islands
2020-07-11,MS,35419,298924,334343,28,Mississippi
2020-07-11,MT,1677,111682,113359,30,Montana
2020-07-11,NC,83793,1092265,1176058,37,North Carolina
2020-07-11,ND,4243,116608,120851,38,North Dakota
2020-07-11,NE,20777,183077,203854,31,Nebraska
2020-07-11,NH,5991,126311,132302,33,New Hampshire
2020-07-11,NJ,174959,1486325,1661284,34,New Jersey
2020-07-11,NM,14549,389032,403581,35,New Mexico
2020-07-11,NV,26838,314395,341233,32,Nevada
2020-07-11,NY,401029,4209748,4610777,36,New York
2020-07-11,OH,64214,918821,983035,39,Ohio
2020-07-11,OK,19779,400037,419816,40,Oklahoma
2020-07-11,OR,11851,280332,292183,41,Oregon
2020-07-11,PA,94689,817634,912323,42,Pennsylvania
2020-07-11,PR,9366,192686,202052,72,Puerto Rico
2020-07-11,RI,17312,149343,166655,44,Rhode Island
2020-07-11,SC,54699,433391,488090,45,South Carolina
2020-07-11,SD,7454,82152,89606,46,South Dakota
2020-07-11,TN,61006,946108,1007114,47,Tennessee
2020-07-11,TX,250462,2179162,2429624,48,Texas
2020-07-11,UT,28855,376497,405352,49,Utah
2020-07-11,VA,69782,716553,786335,51,Virginia
2020-07-11,VI,167,3640,3807,78,U.S. Virgin Islands
2020-07-11,VT,1283,73749,75032,50,Vermont
2020-07-11,WA,39218,629248,668466,53,Washington
2020-07-11,WI,39080,646504,685584,55,Wisconsin
2020-07-11,WV,4074,199749,203823,54,West Virginia
2020-07-11,WY,1839,38077,39916,56,Wyoming
2020-07-10,AK,1323,140608,141931,02,Alaska
2020-07-10,AL,50508,441708,492216,01,Alabama
2020-07-10,AR,26803,338609,365412,05,Arkansas
2020-07-10,AS,0,816,816,60,American Samoa
2020-07-10,AZ,116892,552319,669211,04,Arizona
2020-07-10,CA,304297,4871440,5175737,06,California
2020-07-10,CO,35525,341615,377140,08,Colorado
2020-07-10,CT,47287,511174,558461,09,Connecticut
2020-07-10,DC,10743,110141,120884,11,District of Columbia
2020-07-10,DE,12652,120056,132708,10,Delaware
2020-07-10,FL,244151,2177476,2421627,12,Florida
2020-07-10,GA,111211,935137,1046348,13,Georgia
2020-07-10,GU,310,16556,16866,66,Guam
2020-07-10,HI,1130,89465,90595,15,Hawaii
2020-07-10,IA,33984,328264,362248,19,Iowa
2020-07-10,ID,9428,108650,118078,16,Idaho
2020-07-10,IL,152899,1759976,1912875,17,Illinois
2020-07-10,IN,50300,500262,550562,18,Indiana
2020-07-10,KS,18611,199168,217779,20,Kansas
2020-07-10,KY,18670,414020,432690,21,Kentucky
2020-07-10,LA,74636,830612,905248,22,Louisiana
2020-07-10,MA,111110,827506,938616,25,Massachusetts
2020-07-10,MD,71910,549153,621063,24,Maryland
2020-07-10,ME,3499,114907,118406,23,Maine
2020-07-10,MI,75685,1171120,1246805,26,Michigan
2020-07-10,MN,40767,685058,725825,27,Minnesota
2020-07-10,MO,25999,428826,454825,29,Missouri
2020-07-10,MP,31,10734,10765,69,Northern Mariana Islands
2020-07-10,MS,34622,295690,330312,28,Mississippi
2020-07-10,MT,1593,110585,112178,30,Montana
2020-07-10,NC,81331,1069281,1150612,37,North Carolina
2020-07-10,ND,4154,115442,119596,38,North Dakota
2020-07-10,NE,20623,180391,201014,31,Nebraska
2020-07-10,NH,5973,125078,131051,33,New Hampshire
2020-07-10,NJ,174628,1448530,1623158,34,New Jersey
2020-07-10,NM,14251,381630,395881,35,New Mexico
2020-07-10,NV,25908,309583,335491,32,Nevada
2020-07-10,NY,400299,4141275,4541574,36,New York
2020-07-10,OH,62856,896697,959553,39,Ohio
2020-07-10,OK,19092,391982,411074,40,Oklahoma
2020-07-10,OR,11454,275316,286770,41,Oregon
2020-07-10,PA,93876,804764,898640,42,Pennsylvania
2020-07-10,PR,9137,255766,264903,72,Puerto Rico
2020-07-10,RI,17312,149343,166655,44,Rhode Island
2020-07-10,SC,52419,422816,475235,45,South Carolina
2020-07-10,SD,7401,81141,88542,46,South Dakota
2020-07-10,TN,59546,935029,994575,47,Tennessee
2020-07-10,TX,240111,2149678,2389789,48,Texas
2020-07-10,UT,28223,367751,395974,49,Utah
2020-07-10,VA,68931,699794,768725,51,Virginia
2020-07-10,VI,153,3473,3626,78,U.S. Virgin Islands
2020-07-10,VT,1277,72821,74098,50,Vermont
2020-07-10,WA,38581,621749,660330,53,Washington
2020-07-10,WI,38099,635411,673510,55,Wisconsin
2020-07-10,WV,3983,197220,201203,54,West Virginia
2020-07-10,WY,1790,38077,39867,56,Wyoming
2020-07-09,AK,1272,134472,135744,02,Alaska
2020-07-09,AL,49174,421330,470504,01,Alabama
2020-07-09,AR,26052,338609,364661,05,Arkansas
2020-07-09,AS,0,816,816,60,American Samoa
2020-07-09,AZ,112671,540390,653061,04,Arizona
2020-07-09,CA,296499,4781935,5078434,06,California
2020-07-09,CO,35116,335586,370702,08,Colorado
2020-07-09,CT,47209,511233,558442,09,Connecticut
2020-07-09,DC,10679,105244,115923,11,District of Columbia
2020-07-09,DE,12531,117674,130205,10,Delaware
2020-07-09,FL,232718,2124680,2357398,12,Florida
2020-07-09,GA,106727,912695,1019422,13,Georgia
2020-07-09,GU,309,16223,16532,66,Guam
2020-07-09,HI,1094,88058,89152,15,Hawaii
2020-07-09,IA,33240,321419,354659,19,Iowa
2020-07-09,ID,8969,105651,114620,16,Idaho
2020-07-09,IL,151572,1728306,1879878,17,Illinois
2020-07-09,IN,49575,492717,542292,18,Indiana
2020-07-09,KS,17618,190864,208482,20,Kansas
2020-07-09,KY,18245,405768,424013,21,Kentucky
2020-07-09,LA,71994,808146,880140,22,Louisiana
2020-07-09,MA,110897,814864,925761,25,Massachusetts
2020-07-09,MD,71447,541134,612581,24,Maryland
2020-07-09,ME,3486,112272,115758,23,Maine
2020-07-09,MI,75063,1148490,1223553,26,Michigan
2020-07-09,MN,40163,665277,705440,27,Minnesota
2020-07-09,MO,25999,428826,454825,29,Missouri
2020-07-09,MP,31,10734,10765,69,Northern Mariana Islands
2020-07-09,MS,33591,291213,324804,28,Mississippi
2020-07-09,MT,1466,107299,108765,30,Montana
2020-07-09,NC,79349,1042462,1121811,37,North Carolina
2020-07-09,ND,4070,113779,117849,38,North Dakota
2020-07-09,NE,20425,177410,197835,31,Nebraska
2020-07-09,NH,5952,123676,129628,33,New Hampshire
2020-07-09,NJ,174240,1425177,1599417,34,New Jersey
2020-07-09,NM,14017,375670,389687,35,New Mexico
2020-07-09,NV,24904,304874,329778,32,Nevada
2020-07-09,NY,399513,4068503,4468016,36,New York
2020-07-09,OH,61331,855071,916402,39,Ohio
2020-07-09,OK,18496,383258,401754,40,Oklahoma
2020-07-09,OR,11188,270887,282075,41,Oregon
2020-07-09,PA,92867,787156,880023,42,Pennsylvania
2020-07-09,PR,8862,255766,264628,72,Puerto Rico
2020-07-09,RI,17243,147894,165137,44,Rhode Island
2020-07-09,SC,50691,413074,463765,45,South Carolina
2020-07-09,SD,7336,79974,87310,46,South Dakota
2020-07-09,TN,57591,915123,972714,47,Tennessee
2020-07-09,TX,230346,2082866,2313212,48,Texas
2020-07-09,UT,27356,361377,388733,49,Utah
2020-07-09,VA,67988,685440,753428,51,Virginia
2020-07-09,VI,144,3370,3514,78,U.S. Virgin Islands
2020-07-09,VT,1272,71477,72749,50,Vermont
2020-07-09,WA,37941,607131,645072,53,Washington
2020-07-09,WI,37210,623554,660764,55,Wisconsin
2020-07-09,WV,3826,193363,197189,54,West Virginia
2020-07-09,WY,1774,37271,39045,56,Wyoming
2020-07-08,AK,1226,132175,133401,02,Alaska
2020-07-08,AL,46962,421330,468292,01,Alabama
2020-07-08,AR,24512,328760,353272,05,Arkansas
2020-07-08,AS,0,816,816,60,American Samoa
2020-07-08,AZ,108614,532456,641070,04,Arizona
2020-07-08,CA,289468,4706707,4996175,06,California
2020-07-08,CO,34664,330409,365073,08,Colorado
2020-07-08,CT,47108,498895,546003,09,Connecticut
2020-07-08,DC,10642,103647,114289,11,District of Columbia
2020-07-08,DE,12462,116572,129034,10,Delaware
2020-07-08,FL,223783,2096424,2320207,12,Florida
2020-07-08,GA,103890,896519,1000409,13,Georgia
2020-07-08,GU,307,15833,16140,66,Guam
2020-07-08,HI,1071,86025,87096,15,Hawaii
2020-07-08,IA,32509,313842,346351,19,Iowa
2020-07-08,ID,8539,102792,111331,16,Idaho
2020-07-08,IL,150554,1693144,1843698,17,Illinois
2020-07-08,IN,49063,486794,535857,18,Indiana
2020-07-08,KS,17618,190864,208482,20,Kansas
2020-07-08,KY,17919,398002,415921,21,Kentucky
2020-07-08,LA,70151,795586,865737,22,Louisiana
2020-07-08,MA,110602,805393,915995,25,Massachusetts
2020-07-08,MD,70861,532247,603108,24,Maryland
2020-07-08,ME,3460,109478,112938,23,Maine
2020-07-08,MI,74551,1125452,1200003,26,Michigan
2020-07-08,MN,39589,653381,692970,27,Minnesota
2020-07-08,MO,25204,417136,442340,29,Missouri
2020-07-08,MP,31,10734,10765,69,Northern Mariana Islands
2020-07-08,MS,32888,283431,316319,28,Mississippi
2020-07-08,MT,1371,105050,106421,30,Montana
2020-07-08,NC,77310,1019372,1096682,37,North Carolina
2020-07-08,ND,3971,111868,115839,38,North Dakota
2020-07-08,NE,20201,174847,195048,31,Nebraska
2020-07-08,NH,5932,122579,128511,33,New Hampshire
2020-07-08,NJ,174039,1403809,1577848,34,New Jersey
2020-07-08,NM,13727,371515,385242,35,New Mexico
2020-07-08,NV,24301,299352,323653,32,Nevada
2020-07-08,NY,398929,4003523,4402452,36,New York
2020-07-08,OH,60181,855071,915252,39,Ohio
2020-07-08,OK,17893,376930,394823,40,Oklahoma
2020-07-08,OR,10817,265450,276267,41,Oregon
2020-07-08,PA,92148,774378,866526,42,Pennsylvania
2020-07-08,PR,8745,192686,201431,72,Puerto Rico
2020-07-08,RI,17204,146066,163270,44,Rhode Island
2020-07-08,SC,48909,404931,453840,45,South Carolina
2020-07-08,SD,7242,78984,86226,46,South Dakota
2020-07-08,TN,55986,894973,950959,47,Tennessee
2020-07-08,TX,220564,2038144,2258708,48,Texas
2020-07-08,UT,26755,359005,385760,49,Utah
2020-07-08,VA,67375,670624,737999,51,Virginia
2020-07-08,VI,122,3273,3395,78,U.S. Virgin Islands
2020-07-08,VT,1256,70500,71756,50,Vermont
2020-07-08,WA,37420,598104,635524,53,Washington
2020-07-08,WI,36410,611150,647560,55,Wisconsin
2020-07-08,WV,3707,190208,193915,54,West Virginia
2020-07-08,WY,1740,36078,37818,56,Wyoming
2020-07-07,AK,1184,130236,131420,02,Alaska
2020-07-07,AL,45785,415579,461364,01,Alabama
2020-07-07,AR,24512,326143,350655,05,Arkansas
2020-07-07,AS,0,696,696,60,American Samoa
2020-07-07,AZ,105094,523703,628797,04,Arizona
2020-07-07,CA,277774,4618596,4896370,06,California
2020-07-07,CO,34257,326383,360640,08,Colorado
2020-07-07,CT,47033,490793,537826,09,Connecticut
2020-07-07,DC,10569,99808,110377,11,District of Columbia
2020-07-07,DE,12414,116271,128685,10,Delaware
2020-07-07,FL,213794,2055400,2269194,12,Florida
2020-07-07,GA,100470,878982,979452,13,Georgia
2020-07-07,GU,303,15608,15911,66,Guam
2020-07-07,HI,1030,84643,85673,15,Hawaii
2020-07-07,IA,32029,307269,339298,19,Iowa
2020-07-07,ID,8052,100489,108541,16,Idaho
2020-07-07,IL,149574,1661382,1810956,17,Illinois
2020-07-07,IN,48626,481449,530075,18,Indiana
2020-07-07,KS,16901,185318,202219,20,Kansas
2020-07-07,KY,17519,392353,409872,21,Kentucky
2020-07-07,LA,68263,779335,847598,22,Louisiana
2020-07-07,MA,110338,796422,906760,25,Massachusetts
2020-07-07,MD,70396,523982,594378,24,Maryland
2020-07-07,ME,3440,107466,110906,23,Maine
2020-07-07,MI,73900,1102611,1176511,26,Michigan
2020-07-07,MN,39133,646114,685247,27,Minnesota
2020-07-07,MO,24629,410719,435348,29,Missouri
2020-07-07,MP,31,8187,8218,69,Northern Mariana Islands
2020-07-07,MS,32214,283431,315645,28,Mississippi
2020-07-07,MT,1327,104000,105327,30,Montana
2020-07-07,NC,75875,995415,1071290,37,North Carolina
2020-07-07,ND,3898,110459,114357,38,North Dakota
2020-07-07,NE,20046,173027,193073,31,Nebraska
2020-07-07,NH,5914,121966,127880,33,New Hampshire
2020-07-07,NJ,173878,1386255,1560133,34,New Jersey
2020-07-07,NM,13507,366733,380240,35,New Mexico
2020-07-07,NV,23785,292761,316546,32,Nevada
2020-07-07,NY,398237,3946630,4344867,36,New York
2020-07-07,OH,58904,837581,896485,39,Ohio
2020-07-07,OK,17220,371798,389018,40,Oklahoma
2020-07-07,OR,10605,261301,271906,41,Oregon
2020-07-07,PA,91299,758803,850102,42,Pennsylvania
2020-07-07,PR,8714,192686,201400,72,Puerto Rico
2020-07-07,RI,17204,146066,163270,44,Rhode Island
2020-07-07,SC,47352,397939,445291,45,South Carolina
2020-07-07,SD,7163,78202,85365,46,South Dakota
2020-07-07,TN,53514,867685,921199,47,Tennessee
2020-07-07,TX,210585,2010702,2221287,48,Texas
2020-07-07,UT,26033,356816,382849,49,Utah
2020-07-07,VA,66740,661377,728117,51,Virginia
2020-07-07,VI,116,3183,3299,78,U.S. Virgin Islands
2020-07-07,VT,1254,69859,71113,50,Vermont
2020-07-07,WA,36985,592271,629256,53,Washington
2020-07-07,WI,35765,601012,636777,55,Wisconsin
2020-07-07,WV,3461,186386,189847,54,West Virginia
2020-07-07,WY,1711,36078,37789,56,Wyoming
2020-07-06,AK,1138,122615,123753,02,Alaska
2020-07-06,AL,44878,410217,455095,01,Alabama
2020-07-06,AR,24253,320715,344968,05,Arkansas
2020-07-06,AS,0,696,696,60,American Samoa
2020-07-06,AZ,101441,516400,617841,04,Arizona
2020-07-06,CA,271684,4521669,4793353,06,California
2020-07-06,CO,34065,321590,355655,08,Colorado
2020-07-06,CT,46976,483537,530513,09,Connecticut
2020-07-06,DC,10515,97135,107650,11,District of Columbia
2020-07-06,DE,12293,114886,127179,10,Delaware
2020-07-06,FL,206447,2027493,2233940,12,Florida
2020-07-06,GA,97064,861889,958953,13,Georgia
2020-07-06,GU,301,15248,15549,66,Guam
2020-07-06,HI,1023,84035,85058,15,Hawaii
2020-07-06,IA,31657,303805,335462,19,Iowa
2020-07-06,ID,7733,98732,106465,16,Idaho
2020-07-06,IL,148987,1634975,1783962,17,Illinois
2020-07-06,IN,48331,478261,526592,18,Indiana
2020-07-06,KS,16901,185318,202219,20,Kansas
2020-07-06,KY,17152,383190,400342,21,Kentucky
2020-07-06,LA,66327,747318,813645,22,Louisiana
2020-07-06,MA,110137,789280,899417,25,Massachusetts
2020-07-06,MD,69904,517457,587361,24,Maryland
2020-07-06,ME,3423,106127,109550,23,Maine
2020-07-06,MI,73269,1086094,1159363,26,Michigan
2020-07-06,MN,38569,641124,679693,27,Minnesota
2020-07-06,MO,23856,402889,426745,29,Missouri
2020-07-06,MP,31,8187,8218,69,Northern Mariana Islands
2020-07-06,MS,31257,283431,314688,28,Mississippi
2020-07-06,MT,1249,101677,102926,30,Montana
2020-07-06,NC,74529,977317,1051846,37,North Carolina
2020-07-06,ND,3849,109733,113582,38,North Dakota
2020-07-06,NE,19929,171811,191740,31,Nebraska
2020-07-06,NH,5897,119338,125235,33,New Hampshire
2020-07-06,NJ,173611,1375598,1549209,34,New Jersey
2020-07-06,NM,13256,361798,375054,35,New Mexico
2020-07-06,NV,22909,288572,311481,32,Nevada
2020-07-06,NY,397649,3890482,4288131,36,New York
2020-07-06,OH,57956,823456,881412,39,Ohio
2020-07-06,OK,16362,348789,365151,40,Oklahoma
2020-07-06,OR,10395,257326,267721,41,Oregon
2020-07-06,PA,90304,743020,833324,42,Pennsylvania
2020-07-06,PR,8585,192686,201271,72,Puerto Rico
2020-07-06,RI,17163,144551,161714,44,Rhode Island
2020-07-06,SC,46380,393477,439857,45,South Carolina
2020-07-06,SD,7105,77198,84303,46,South Dakota
2020-07-06,TN,52155,852463,904618,47,Tennessee
2020-07-06,TX,200557,1963172,2163729,48,Texas
2020-07-06,UT,25469,350373,375842,49,Utah
2020-07-06,VA,66102,649011,715113,51,Virginia
2020-07-06,VI,112,3118,3230,78,U.S. Virgin Islands
2020-07-06,VT,1251,69102,70353,50,Vermont
2020-07-06,WA,35898,576808,612706,53,Washington
2020-07-06,WI,35230,588913,624143,55,Wisconsin
2020-07-06,WV,3442,185539,188981,54,West Virginia
2020-07-06,WY,1634,33693,35327,56,Wyoming
2020-07-05,AK,1138,122615,123753,02,Alaska
2020-07-05,AL,43953,405933,449886,01,Alabama
2020-07-05,AR,23209,315684,338893,05,Arkansas
2020-07-05,AS,0,696,696,60,American Samoa
2020-07-05,AZ,98089,506273,604362,04,Arizona
2020-07-05,CA,265985,4414153,4680138,06,California
2020-07-05,CO,33866,316851,350717,08,Colorado
2020-07-05,CT,46717,477851,524568,09,Connecticut
2020-07-05,DC,10482,95511,105993,11,District of Columbia
2020-07-05,DE,12128,111813,123941,10,Delaware
2020-07-05,FL,200111,2000088,2200199,12,Florida
2020-07-05,GA,95516,853669,949185,13,Georgia
2020-07-05,GU,288,14666,14954,66,Guam
2020-07-05,HI,999,83326,84325,15,Hawaii
2020-07-05,IA,31353,301119,332472,19,Iowa
2020-07-05,ID,7370,96896,104266,16,Idaho
2020-07-05,IL,148373,1614455,1762828,17,Illinois
2020-07-05,IN,48008,473714,521722,18,Indiana
2020-07-05,KS,15919,175642,191561,20,Kansas
2020-07-05,KY,16376,379271,395647,21,Kentucky
2020-07-05,LA,65226,737228,802454,22,Louisiana
2020-07-05,MA,109974,781711,891685,25,Massachusetts
2020-07-05,MD,69632,510330,579962,24,Maryland
2020-07-05,ME,3415,104517,107932,23,Maine
2020-07-05,MI,72941,1073878,1146819,26,Michigan
2020-07-05,MN,38136,635879,674015,27,Minnesota
2020-07-05,MO,23436,396073,419509,29,Missouri
2020-07-05,MP,31,8187,8218,69,Northern Mariana Islands
2020-07-05,MS,30900,279241,310141,28,Mississippi
2020-07-05,MT,1212,98894,100106,30,Montana
2020-07-05,NC,72983,963855,1036838,37,North Carolina
2020-07-05,ND,3816,109312,113128,38,North Dakota
2020-07-05,NE,19827,170101,189928,31,Nebraska
2020-07-05,NH,5857,117892,123749,33,New Hampshire
2020-07-05,NJ,173402,1361238,1534640,34,New Jersey
2020-07-05,NM,13063,359225,372288,35,New Mexico
2020-07-05,NV,22418,285279,307697,32,Nevada
2020-07-05,NY,397131,3836672,4233803,36,New York
2020-07-05,OH,57151,811611,868762,39,Ohio
2020-07-05,OK,15928,348789,364717,40,Oklahoma
2020-07-05,OR,10230,253971,264201,41,Oregon
2020-07-05,PA,89854,734846,824700,42,Pennsylvania
2020-07-05,PR,7916,192686,200602,72,Puerto Rico
2020-07-05,RI,17108,143047,160155,44,Rhode Island
2020-07-05,SC,44847,385962,430809,45,South Carolina
2020-07-05,SD,7063,76940,84003,46,South Dakota
2020-07-05,TN,51431,844735,896166,47,Tennessee
2020-07-05,TX,195239,1938218,2133457,48,Texas
2020-07-05,UT,24952,346356,371308,49,Utah
2020-07-05,VA,65748,643607,709355,51,Virginia
2020-07-05,VI,111,3060,3171,78,U.S. Virgin Islands
2020-07-05,VT,1249,68775,70024,50,Vermont
2020-07-05,WA,35247,572029,607276,53,Washington
2020-07-05,WI,34740,584111,618851,55,Wisconsin
2020-07-05,WV,3262,181559,184821,54,West Virginia
2020-07-05,WY,1634,33693,35327,56,Wyoming
2020-07-04,AK,1111,121621,122732,02,Alaska
2020-07-04,AL,42862,399226,442088,01,Alabama
2020-07-04,AR,23209,315684,338893,05,Arkansas
2020-07-04,AS,0,696,696,60,American Samoa
2020-07-04,AZ,94553,494955,589508,04,Arizona
2020-07-04,CA,257388,4295643,4553031,06,California
2020-07-04,CO,33619,312135,345754,08,Colorado
2020-07-04,CT,46717,453309,500026,09,Connecticut
2020-07-04,DC,10447,94107,104554,11,District of Columbia
2020-07-04,DE,11996,108697,120693,10,Delaware
2020-07-04,FL,190052,1956445,2146497,12,Florida
2020-07-04,GA,93319,833040,926359,13,Georgia
2020-07-04,GU,288,14666,14954,66,Guam
2020-07-04,HI,975,82501,83476,15,Hawaii
2020-07-04,IA,31041,297970,329011,19,Iowa
2020-07-04,ID,6994,94073,101067,16,Idaho
2020-07-04,IL,147734,1587859,1735593,17,Illinois
2020-07-04,IN,47432,464856,512288,18,Indiana
2020-07-04,KS,15919,175642,191561,20,Kansas
2020-07-04,KY,16376,379271,395647,21,Kentucky
2020-07-04,LA,63289,720853,784142,22,Louisiana
2020-07-04,MA,109838,775929,885767,25,Massachusetts
2020-07-04,MD,69341,504001,573342,24,Maryland
2020-07-04,ME,3397,102548,105945,23,Maine
2020-07-04,MI,72581,1057573,1130154,26,Michigan
2020-07-04,MN,37624,607548,645172,27,Minnesota
2020-07-04,MO,23215,389046,412261,29,Missouri
2020-07-04,MP,31,8187,8218,69,Northern Mariana Islands
2020-07-04,MS,30674,279241,309915,28,Mississippi
2020-07-04,MT,1167,97783,98950,30,Montana
2020-07-04,NC,71654,946642,1018296,37,North Carolina
2020-07-04,ND,3779,108149,111928,38,North Dakota
2020-07-04,NE,19660,167928,187588,31,Nebraska
2020-07-04,NH,5857,117892,123749,33,New Hampshire
2020-07-04,NJ,173033,1335515,1508548,34,New Jersey
2020-07-04,NM,12776,350598,363374,35,New Mexico
2020-07-04,NV,21575,279654,301229,32,Nevada
2020-07-04,NY,396598,3773790,4170388,36,New York
2020-07-04,OH,56183,792187,848370,39,Ohio
2020-07-04,OK,15645,348789,364434,40,Oklahoma
2020-07-04,OR,9930,245096,255026,41,Oregon
2020-07-04,PA,89375,725448,814823,42,Pennsylvania
2020-07-04,PR,7787,192686,200473,72,Puerto Rico
2020-07-04,RI,17084,141673,158757,44,Rhode Island
2020-07-04,SC,43386,377307,420693,45,South Carolina
2020-07-04,SD,7028,76802,83830,46,South Dakota
2020-07-04,TN,50140,828464,878604,47,Tennessee
2020-07-04,TX,191790,1880019,2071809,48,Texas
2020-07-04,UT,24542,342174,366716,49,Utah
2020-07-04,VA,65109,634120,699229,51,Virginia
2020-07-04,VI,111,3060,3171,78,U.S. Virgin Islands
2020-07-04,VT,1238,68159,69397,50,Vermont
2020-07-04,WA,34778,565197,599975,53,Washington
2020-07-04,WI,34207,579637,613844,55,Wisconsin
2020-07-04,WV,3141,178288,181429,54,West Virginia
2020-07-04,WY,1606,33693,35299,56,Wyoming
2020-07-03,AK,1063,119145,120208,02,Alaska
2020-07-03,AL,41865,388766,430631,01,Alabama
2020-07-03,AR,22622,308615,331237,05,Arkansas
2020-07-03,AS,0,696,696,60,American Samoa
2020-07-03,AZ,91858,486523,578381,04,Arizona
2020-07-03,CA,248235,4199941,4448176,06,California
2020-07-03,CO,33352,306938,340290,08,Colorado
2020-07-03,CT,46717,453369,500086,09,Connecticut
2020-07-03,DC,10435,92374,102809,11,District of Columbia
2020-07-03,DE,11923,106420,118343,10,Delaware
2020-07-03,FL,178594,1902766,2081360,12,Florida
2020-07-03,GA,90493,810724,901217,13,Georgia
2020-07-03,GU,286,14263,14549,66,Guam
2020-07-03,HI,946,80672,81618,15,Hawaii
2020-07-03,IA,30429,291032,321461,19,Iowa
2020-07-03,ID,6593,92116,98709,16,Idaho
2020-07-03,IL,146872,1554885,1701757,17,Illinois
2020-07-03,IN,46915,457238,504153,18,Indiana
2020-07-03,KS,15919,175642,191561,20,Kansas
2020-07-03,KY,16376,379271,395647,21,Kentucky
2020-07-03,LA,63289,720853,784142,22,Louisiana
2020-07-03,MA,109628,768152,877780,25,Massachusetts
2020-07-03,MD,68961,494873,563834,24,Maryland
2020-07-03,ME,3373,100076,103449,23,Maine
2020-07-03,MI,72175,1036090,1108265,26,Michigan
2020-07-03,MN,37624,607548,645172,27,Minnesota
2020-07-03,MO,22830,382129,404959,29,Missouri
2020-07-03,MP,31,8187,8218,69,Northern Mariana Islands
2020-07-03,MS,28770,270269,299039,28,Mississippi
2020-07-03,MT,1128,96375,97503,30,Montana
2020-07-03,NC,70241,929052,999293,37,North Carolina
2020-07-03,ND,3722,106852,110574,38,North Dakota
2020-07-03,NE,19452,164682,184134,31,Nebraska
2020-07-03,NH,5822,116365,122187,33,New Hampshire
2020-07-03,NJ,172742,1312759,1485501,34,New Jersey
2020-07-03,NM,12520,344117,356637,35,New Mexico
2020-07-03,NV,20718,272967,293685,32,Nevada
2020-07-03,NY,395872,3712113,4107985,36,New York
2020-07-03,OH,55257,772900,828157,39,Ohio
2020-07-03,OK,15065,348789,363854,40,Oklahoma
2020-07-03,OR,9636,245096,254732,41,Oregon
2020-07-03,PA,88741,715403,804144,42,Pennsylvania
2020-07-03,PR,7683,192686,200369,72,Puerto Rico
2020-07-03,RI,17057,140721,157778,44,Rhode Island
2020-07-03,SC,41532,367500,409032,45,South Carolina
2020-07-03,SD,6978,76015,82993,46,South Dakota
2020-07-03,TN,48712,813777,862489,47,Tennessee
2020-07-03,TX,183532,1830374,2013906,48,Texas
2020-07-03,UT,23866,332770,356636,49,Utah
2020-07-03,VA,64393,623967,688360,51,Virginia
2020-07-03,VI,98,2963,3061,78,U.S. Virgin Islands
2020-07-03,VT,1236,67159,68395,50,Vermont
2020-07-03,WA,34151,550838,584989,53,Washington
2020-07-03,WI,33431,573553,606984,55,Wisconsin
2020-07-03,WV,3126,177576,180702,54,West Virginia
2020-07-03,WY,1582,33693,35275,56,Wyoming
2020-07-02,AK,1017,114892,115909,02,Alaska
2020-07-02,AL,40111,379617,419728,01,Alabama
2020-07-02,AR,22075,301912,323987,05,Arkansas
2020-07-02,AS,0,696,696,60,American Samoa
2020-07-02,AZ,87425,473414,560839,04,Arizona
2020-07-02,CA,242547,4096171,4338718,06,California
2020-07-02,CO,33029,300226,333255,08,Colorado
2020-07-02,CT,46646,453468,500114,09,Connecticut
2020-07-02,DC,10390,90673,101063,11,District of Columbia
2020-07-02,DE,11731,103187,114918,10,Delaware
2020-07-02,FL,169106,1863077,2032183,12,Florida
2020-07-02,GA,87709,795530,883239,13,Georgia
2020-07-02,GU,280,13653,13933,66,Guam
2020-07-02,HI,926,79364,80290,15,Hawaii
2020-07-02,IA,30209,287329,317538,19,Iowa
2020-07-02,ID,6370,88751,95121,16,Idaho
2020-07-02,IL,145935,1521435,1667370,17,Illinois
2020-07-02,IN,46387,450448,496835,18,Indiana
2020-07-02,KS,14990,168183,183173,20,Kansas
2020-07-02,KY,16079,369715,385794,21,Kentucky
2020-07-02,LA,61561,705813,767374,22,Louisiana
2020-07-02,MA,109338,756920,866258,25,Massachusetts
2020-07-02,MD,68423,484752,553175,24,Maryland
2020-07-02,ME,3328,97489,100817,23,Maine
2020-07-02,MI,71678,1013459,1085137,26,Michigan
2020-07-02,MN,37210,593217,630427,27,Minnesota
2020-07-02,MO,22283,375035,397318,29,Missouri
2020-07-02,MP,30,8187,8217,69,Northern Mariana Islands
2020-07-02,MS,28770,270269,299039,28,Mississippi
2020-07-02,MT,1083,94066,95149,30,Montana
2020-07-02,NC,68142,902978,971120,37,North Carolina
2020-07-02,ND,3657,104538,108195,38,North Dakota
2020-07-02,NE,19310,163352,182662,31,Nebraska
2020-07-02,NH,5802,114505,120307,33,New Hampshire
2020-07-02,NJ,172356,1291557,1463913,34,New Jersey
2020-07-02,NM,12276,337784,350060,35,New Mexico
2020-07-02,NV,19733,264995,284728,32,Nevada
2020-07-02,NY,394954,3646639,4041593,36,New York
2020-07-02,OH,54166,739140,793306,39,Ohio
2020-07-02,OK,14539,338511,353050,40,Oklahoma
2020-07-02,OR,9294,241760,251054,41,Oregon
2020-07-02,PA,88074,702199,790273,42,Pennsylvania
2020-07-02,PR,7608,192686,200294,72,Puerto Rico
2020-07-02,RI,17035,140048,157083,44,Rhode Island
2020-07-02,SC,39701,361700,401401,45,South Carolina
2020-07-02,SD,6893,75048,81941,46,South Dakota
2020-07-02,TN,46890,791564,838454,47,Tennessee
2020-07-02,TX,175977,1799826,1975803,48,Texas
2020-07-02,UT,23270,323116,346386,49,Utah
2020-07-02,VA,63735,610521,674256,51,Virginia
2020-07-02,VI,92,2924,3016,78,U.S. Virgin Islands
2020-07-02,VT,1227,66114,67341,50,Vermont
2020-07-02,WA,33435,538529,571964,53,Washington
2020-07-02,WI,32809,563946,596755,55,Wisconsin
2020-07-02,WV,3053,175288,178341,54,West Virginia
2020-07-02,WY,1550,33693,35243,56,Wyoming
2020-07-01,AK,978,113422,114400,02,Alaska
2020-07-01,AL,38962,374991,413953,01,Alabama
2020-07-01,AR,21197,293661,314858,05,Arkansas
2020-07-01,AS,0,696,696,60,American Samoa
2020-07-01,AZ,84092,465504,549596,04,Arizona
2020-07-01,CA,236139,4018037,4254176,06,California
2020-07-01,CO,32715,294788,327503,08,Colorado
2020-07-01,CT,46572,443237,489809,09,Connecticut
2020-07-01,DC,10365,89670,100035,11,District of Columbia
2020-07-01,DE,11510,99874,111384,10,Delaware
2020-07-01,FL,158997,1821357,1980354,12,Florida
2020-07-01,GA,84237,770801,855038,13,Georgia
2020-07-01,GU,267,13517,13784,66,Guam
2020-07-01,HI,917,78141,79058,15,Hawaii
2020-07-01,IA,29451,280339,309790,19,Iowa
2020-07-01,ID,6117,84923,91040,16,Idaho
2020-07-01,IL,145066,1492042,1637108,17,Illinois
2020-07-01,IN,45952,443764,489716,18,Indiana
2020-07-01,KS,14990,168183,183173,20,Kansas
2020-07-01,KY,15842,361248,377090,21,Kentucky
2020-07-01,LA,60178,691910,752088,22,Louisiana
2020-07-01,MA,109143,749292,858435,25,Massachusetts
2020-07-01,MD,67918,474686,542604,24,Maryland
2020-07-01,ME,3294,93947,97241,23,Maine
2020-07-01,MI,71089,990770,1061859,26,Michigan
2020-07-01,MN,36716,580391,617107,27,Minnesota
2020-07-01,MO,21927,367813,389740,29,Missouri
2020-07-01,MP,30,8187,8217,69,Northern Mariana Islands
2020-07-01,MS,27900,265852,293752,28,Mississippi
2020-07-01,MT,1016,92314,93330,30,Montana
2020-07-01,NC,66513,875725,942238,37,North Carolina
2020-07-01,ND,3615,103611,107226,38,North Dakota
2020-07-01,NE,19177,161431,180608,31,Nebraska
2020-07-01,NH,5782,113387,119169,33,New Hampshire
2020-07-01,NJ,171928,1271009,1442937,34,New Jersey
2020-07-01,NM,12147,332034,344181,35,New Mexico
2020-07-01,NV,19101,264995,284096,32,Nevada
2020-07-01,NY,394079,3577569,3971648,36,New York
2020-07-01,OH,52865,739140,792005,39,Ohio
2020-07-01,OK,14112,332201,346313,40,Oklahoma
2020-07-01,OR,8931,234429,243360,41,Oregon
2020-07-01,PA,87242,689562,776804,42,Pennsylvania
2020-07-01,PR,7537,192686,200223,72,Puerto Rico
2020-07-01,RI,16976,139063,156039,44,Rhode Island
2020-07-01,SC,37919,351953,389872,45,South Carolina
2020-07-01,SD,6826,74117,80943,46,South Dakota
2020-07-01,TN,45315,772571,817886,47,Tennessee
2020-07-01,TX,168062,1753886,1921948,48,Texas
2020-07-01,UT,22716,320642,343358,49,Utah
2020-07-01,VA,63203,595430,658633,51,Virginia
2020-07-01,VI,90,2876,2966,78,U.S. Virgin Islands
2020-07-01,VT,1210,65082,66292,50,Vermont
2020-07-01,WA,32824,524451,557275,53,Washington
2020-07-01,WI,32225,551607,583832,55,Wisconsin
2020-07-01,WV,2932,170420,173352,54,West Virginia
2020-07-01,WY,1514,32185,33699,56,Wyoming
2020-06-30,AK,940,111245,112185,02,Alaska
2020-06-30,AL,38045,368607,406652,01,Alabama
2020-06-30,AR,20777,290426,311203,05,Arkansas
2020-06-30,AS,0,696,696,60,American Samoa
2020-06-30,AZ,79215,453141,532356,04,Arizona
2020-06-30,CA,228732,3938407,4167139,06,California
2020-06-30,CO,32511,291346,323857,08,Colorado
2020-06-30,CT,46514,431844,478358,09,Connecticut
2020-06-30,DC,10327,86968,97295,11,District of Columbia
2020-06-30,DE,11474,99407,110881,10,Delaware
2020-06-30,FL,152434,1792561,1944995,12,Florida
2020-06-30,GA,81291,752587,833878,13,Georgia
2020-06-30,GU,259,13056,13315,66,Guam
2020-06-30,HI,900,76843,77743,15,Hawaii
2020-06-30,IA,29007,275181,304188,19,Iowa
2020-06-30,ID,5752,83551,89303,16,Idaho
2020-06-30,IL,144238,1459780,1604018,17,Illinois
2020-06-30,IN,45594,438602,484196,18,Indiana
2020-06-30,KS,14443,162282,176725,20,Kansas
2020-06-30,KY,15624,355310,370934,21,Kentucky
2020-06-30,LA,58095,670416,728511,22,Louisiana
2020-06-30,MA,108882,739259,848141,25,Massachusetts
2020-06-30,MD,67559,468296,535855,24,Maryland
2020-06-30,ME,3253,91699,94952,23,Maine
2020-06-30,MI,70728,974329,1045057,26,Michigan
2020-06-30,MN,36303,569013,605316,27,Minnesota
2020-06-30,MO,21551,351456,373007,29,Missouri
2020-06-30,MP,30,8187,8217,69,Northern Mariana Islands
2020-06-30,MS,27247,260299,287546,28,Mississippi
2020-06-30,MT,967,89894,90861,30,Montana
2020-06-30,NC,64670,845363,910033,37,North Carolina
2020-06-30,ND,3576,102546,106122,38,North Dakota
2020-06-30,NE,19042,159115,178157,31,Nebraska
2020-06-30,NH,5760,112538,118298,33,New Hampshire
2020-06-30,NJ,171667,1250707,1422374,34,New Jersey
2020-06-30,NM,11982,325738,337720,35,New Mexico
2020-06-30,NV,18456,259112,277568,32,Nevada
2020-06-30,NY,393454,3521484,3914938,36,New York
2020-06-30,OH,51789,736140,787929,39,Ohio
2020-06-30,OK,13757,327840,341597,40,Oklahoma
2020-06-30,OR,8656,228978,237634,41,Oregon
2020-06-30,PA,86606,677581,764187,42,Pennsylvania
2020-06-30,PR,7465,192686,200151,72,Puerto Rico
2020-06-30,RI,16911,137172,154083,44,Rhode Island
2020-06-30,SC,36399,344173,380572,45,South Carolina
2020-06-30,SD,6764,73324,80088,46,South Dakota
2020-06-30,TN,43509,749618,793127,47,Tennessee
2020-06-30,TX,159986,1709296,1869282,48,Texas
2020-06-30,UT,22217,318536,340753,49,Utah
2020-06-30,VA,62787,582247,645034,51,Virginia
2020-06-30,VI,84,2819,2903,78,U.S. Virgin Islands
2020-06-30,VT,1208,64556,65764,50,Vermont
2020-06-30,WA,32253,515967,548220,53,Washington
2020-06-30,WI,31662,539539,571201,55,Wisconsin
2020-06-30,WV,2905,168859,171764,54,West Virginia
2020-06-30,WY,1487,32185,33672,56,Wyoming
2020-06-29,AK,904,107805,108709,02,Alaska
2020-06-29,AL,37175,356118,393293,01,Alabama
2020-06-29,AR,20257,282279,302536,05,Arkansas
2020-06-29,AS,0,696,696,60,American Samoa
2020-06-29,AZ,74533,436890,511423,04,Arizona
2020-06-29,CA,219252,3842440,4061692,06,California
2020-06-29,CO,32307,287258,319565,08,Colorado
2020-06-29,CT,46362,420460,466822,09,Connecticut
2020-06-29,DC,10292,85068,95360,11,District of Columbia
2020-06-29,DE,11376,98555,109931,10,Delaware
2020-06-29,FL,146341,1766402,1912743,12,Florida
2020-06-29,GA,79417,743700,823117,13,Georgia
2020-06-29,GU,255,12659,12914,66,Guam
2020-06-29,HI,899,76256,77155,15,Hawaii
2020-06-29,IA,28782,272063,300845,19,Iowa
2020-06-29,ID,5319,81026,86345,16,Idaho
2020-06-29,IL,143514,1429435,1572949,17,Illinois
2020-06-29,IN,45228,431291,476519,18,Indiana
2020-06-29,KS,14443,162282,176725,20,Kansas
2020-06-29,KY,15347,346094,361441,21,Kentucky
2020-06-29,LA,57081,647556,704637,22,Louisiana
2020-06-29,MA,108768,733519,842287,25,Massachusetts
2020-06-29,MD,67254,462059,529313,24,Maryland
2020-06-29,ME,3219,90304,93523,23,Maine
2020-06-29,MI,70223,959152,1029375,26,Michigan
2020-06-29,MN,35861,557094,592955,27,Minnesota
2020-06-29,MO,21043,346363,367406,29,Missouri
2020-06-29,MP,30,8187,8217,69,Northern Mariana Islands
2020-06-29,MS,26567,256955,283522,28,Mississippi
2020-06-29,MT,919,87824,88743,30,Montana
2020-06-29,NC,63484,822821,886305,37,North Carolina
2020-06-29,ND,3539,102152,105691,38,North Dakota
2020-06-29,NE,18899,156373,175272,31,Nebraska
2020-06-29,NH,5760,112538,118298,33,New Hampshire
2020-06-29,NJ,171272,1232712,1403984,34,New Jersey
2020-06-29,NM,11809,319239,331048,35,New Mexico
2020-06-29,NV,17894,255123,273017,32,Nevada
2020-06-29,NY,392930,3469983,3862913,36,New York
2020-06-29,OH,51046,723336,774382,39,Ohio
2020-06-29,OK,13172,313021,326193,40,Oklahoma
2020-06-29,OR,8485,226648,235133,41,Oregon
2020-06-29,PA,85988,666901,752889,42,Pennsylvania
2020-06-29,PR,7250,192686,199936,72,Puerto Rico
2020-06-29,RI,16871,136198,153069,44,Rhode Island
2020-06-29,SC,34644,334661,369305,45,South Carolina
2020-06-29,SD,6716,72741,79457,46,South Dakota
2020-06-29,TN,42297,734909,777206,47,Tennessee
2020-06-29,TX,153011,1666178,1819189,48,Texas
2020-06-29,UT,21664,312241,333905,49,Utah
2020-06-29,VA,62189,574183,636372,51,Virginia
2020-06-29,VI,81,2746,2827,78,U.S. Virgin Islands
2020-06-29,VT,1208,63785,64993,50,Vermont
2020-06-29,WA,31752,502691,534443,53,Washington
2020-06-29,WI,31033,527359,558392,55,Wisconsin
2020-06-29,WV,2870,166785,169655,54,West Virginia
2020-06-29,WY,1450,30406,31856,56,Wyoming
2020-06-28,AK,883,107417,108300,02,Alaska
2020-06-28,AL,35441,350839,386280,01,Alabama
2020-06-28,AR,19310,271912,291222,05,Arkansas
2020-06-28,AS,0,696,696,60,American Samoa
2020-06-28,AZ,73908,435988,509896,04,Arizona
2020-06-28,CA,211243,3744709,3955952,06,California
2020-06-28,CO,32022,281689,313711,08,Colorado
2020-06-28,CT,46303,399057,445360,09,Connecticut
2020-06-28,DC,10248,82884,93132,11,District of Columbia
2020-06-28,DE,11226,95120,106346,10,Delaware
2020-06-28,FL,141075,1740822,1881897,12,Florida
2020-06-28,GA,77210,729728,806938,13,Georgia
2020-06-28,GU,248,12130,12378,66,Guam
2020-06-28,HI,872,74606,75478,15,Hawaii
2020-06-28,IA,28489,267426,295915,19,Iowa
2020-06-28,ID,5319,81026,86345,16,Idaho
2020-06-28,IL,142776,1403255,1546031,17,Illinois
2020-06-28,IN,44930,425605,470535,18,Indiana
2020-06-28,KS,13538,154321,167859,20,Kansas
2020-06-28,KY,15232,343259,358491,21,Kentucky
2020-06-28,LA,56236,639875,696111,22,Louisiana
2020-06-28,MA,108667,727127,835794,25,Massachusetts
2020-06-28,MD,66777,452696,519473,24,Maryland
2020-06-28,ME,3191,90304,93495,23,Maine
2020-06-28,MI,69946,946733,1016679,26,Michigan
2020-06-28,MN,35549,549868,585417,27,Minnesota
2020-06-28,MO,20575,340598,361173,29,Missouri
2020-06-28,MP,30,8187,8217,69,Northern Mariana Islands
2020-06-28,MS,25892,254296,280188,28,Mississippi
2020-06-28,MT,863,81611,82474,30,Montana
2020-06-28,NC,62142,809763,871905,37,North Carolina
2020-06-28,ND,3495,100430,103925,38,North Dakota
2020-06-28,NE,18775,154023,172798,31,Nebraska
2020-06-28,NH,5717,110392,116109,33,New Hampshire
2020-06-28,NJ,171182,1216651,1387833,34,New Jersey
2020-06-28,NM,11619,311340,322959,35,New Mexico
2020-06-28,NV,17160,250420,267580,32,Nevada
2020-06-28,NY,392539,3423946,3816485,36,New York
2020-06-28,OH,50309,706456,756765,39,Ohio
2020-06-28,OK,12944,313021,325965,40,Oklahoma
2020-06-28,OR,8341,219529,227870,41,Oregon
2020-06-28,PA,85496,657486,742982,42,Pennsylvania
2020-06-28,PR,7189,113280,120469,72,Puerto Rico
2020-06-28,RI,16835,134878,151713,44,Rhode Island
2020-06-28,SC,33320,326482,359802,45,South Carolina
2020-06-28,SD,6681,72212,78893,46,South Dakota
2020-06-28,TN,40172,708381,748553,47,Tennessee
2020-06-28,TX,148728,1626491,1775219,48,Texas
2020-06-28,UT,21100,307349,328449,49,Utah
2020-06-28,VA,61736,566592,628328,51,Virginia
2020-06-28,VI,81,2746,2827,78,U.S. Virgin Islands
2020-06-28,VT,1202,62663,63865,50,Vermont
2020-06-28,WA,31404,494398,525802,53,Washington
2020-06-28,WI,30707,521747,552454,55,Wisconsin
2020-06-28,WV,2817,163691,166508,54,West Virginia
2020-06-28,WY,1417,30406,31823,56,Wyoming
2020-06-27,AK,854,104727,105581,02,Alaska
2020-06-27,AL,35083,348943,384026,01,Alabama
2020-06-27,AR,18740,265225,283965,05,Arkansas
2020-06-27,AS,0,696,696,60,American Samoa
2020-06-27,AZ,70051,424696,494747,04,Arizona
2020-06-27,CA,206433,3655877,3862310,06,California
2020-06-27,CO,31796,275787,307583,08,Colorado
2020-06-27,CT,46206,392824,439030,09,Connecticut
2020-06-27,DC,10216,79055,89271,11,District of Columbia
2020-06-27,DE,11091,93171,104262,10,Delaware
2020-06-27,FL,132545,1696980,1829525,12,Florida
2020-06-27,GA,74985,714828,789813,13,Georgia
2020-06-27,GU,248,11903,12151,66,Guam
2020-06-27,HI,866,73435,74301,15,Hawaii
2020-06-27,IA,28012,261740,289752,19,Iowa
2020-06-27,ID,5148,78908,84056,16,Idaho
2020-06-27,IL,142130,1380112,1522242,17,Illinois
2020-06-27,IN,44575,418442,463017,18,Indiana
2020-06-27,KS,13538,154321,167859,20,Kansas
2020-06-27,KY,14859,335895,350754,21,Kentucky
2020-06-27,LA,54769,623237,678006,22,Louisiana
2020-06-27,MA,108443,717899,826342,25,Massachusetts
2020-06-27,MD,66450,447366,513816,24,Maryland
2020-06-27,ME,3154,88778,91932,23,Maine
2020-06-27,MI,69679,931142,1000821,26,Michigan
2020-06-27,MN,35033,533874,568907,27,Minnesota
2020-06-27,MO,20261,335029,355290,29,Missouri
2020-06-27,MP,30,8187,8217,69,Northern Mariana Islands
2020-06-27,MS,25531,251790,277321,28,Mississippi
2020-06-27,MT,852,80395,81247,30,Montana
2020-06-27,NC,60537,794594,855131,37,North Carolina
2020-06-27,ND,3458,99061,102519,38,North Dakota
2020-06-27,NE,18524,150074,168598,31,Nebraska
2020-06-27,NH,5671,109097,114768,33,New Hampshire
2020-06-27,NJ,170873,1196377,1367250,34,New Jersey
2020-06-27,NM,11408,309230,320638,35,New Mexico
2020-06-27,NV,16339,246687,263026,32,Nevada
2020-06-27,NY,391923,3362656,3754579,36,New York
2020-06-27,OH,49455,695384,744839,39,Ohio
2020-06-27,OK,12642,313021,325663,40,Oklahoma
2020-06-27,OR,8094,219529,227623,41,Oregon
2020-06-27,PA,84370,634711,719081,42,Pennsylvania
2020-06-27,PR,7066,113280,120346,72,Puerto Rico
2020-06-27,RI,16813,134300,151113,44,Rhode Island
2020-06-27,SC,31939,319225,351164,45,South Carolina
2020-06-27,SD,6626,71474,78100,46,South Dakota
2020-06-27,TN,40172,708381,748553,47,Tennessee
2020-06-27,TX,143371,1579455,1722826,48,Texas
2020-06-27,UT,20628,302174,322802,49,Utah
2020-06-27,VA,61247,556679,617926,51,Virginia
2020-06-27,VI,81,2746,2827,78,U.S. Virgin Islands
2020-06-27,VT,1200,61523,62723,50,Vermont
2020-06-27,WA,30855,483573,514428,53,Washington
2020-06-27,WI,30227,515723,545950,55,Wisconsin
2020-06-27,WV,2761,161894,164655,54,West Virginia
2020-06-27,WY,1392,30406,31798,56,Wyoming
2020-06-26,AK,836,100956,101792,02,Alaska
2020-06-26,AL,34183,344140,378323,01,Alabama
2020-06-26,AR,18062,259318,277380,05,Arkansas
2020-06-26,AS,0,696,696,60,American Samoa
2020-06-26,AZ,66548,413275,479823,04,Arizona
2020-06-26,CA,200461,3570853,3771314,06,California
2020-06-26,CO,31479,271098,302577,08,Colorado
2020-06-26,CT,46059,383765,429824,09,Connecticut
2020-06-26,DC,10185,77938,88123,11,District of Columbia
2020-06-26,DE,11017,91083,102100,10,Delaware
2020-06-26,FL,122960,1645925,1768885,12,Florida
2020-06-26,GA,72995,698033,771028,13,Georgia
2020-06-26,GU,248,11644,11892,66,Guam
2020-06-26,HI,850,72155,73005,15,Hawaii
2020-06-26,IA,27686,255957,283643,19,Iowa
2020-06-26,ID,4865,77505,82370,16,Idaho
2020-06-26,IL,141344,1350661,1492005,17,Illinois
2020-06-26,IN,44140,409750,453890,18,Indiana
2020-06-26,KS,13538,154321,167859,20,Kansas
2020-06-26,KY,14859,335895,350754,21,Kentucky
2020-06-26,LA,54769,623237,678006,22,Louisiana
2020-06-26,MA,108070,706015,814085,25,Massachusetts
2020-06-26,MD,66115,440282,506397,24,Maryland
2020-06-26,ME,3102,86752,89854,23,Maine
2020-06-26,MI,69329,912377,981706,26,Michigan
2020-06-26,MN,34616,522662,557278,27,Minnesota
2020-06-26,MO,19914,328704,348618,29,Missouri
2020-06-26,MP,30,8187,8217,69,Northern Mariana Islands
2020-06-26,MS,25066,246828,271894,28,Mississippi
2020-06-26,MT,829,79332,80161,30,Montana
2020-06-26,NC,58818,777907,836725,37,North Carolina
2020-06-26,ND,3421,97465,100886,38,North Dakota
2020-06-26,NE,18346,146656,165002,31,Nebraska
2020-06-26,NH,5671,109097,114768,33,New Hampshire
2020-06-26,NJ,170584,1176088,1346672,34,New Jersey
2020-06-26,NM,11192,303478,314670,35,New Mexico
2020-06-26,NV,15240,243422,258662,32,Nevada
2020-06-26,NY,391220,3290097,3681317,36,New York
2020-06-26,OH,48638,672914,721552,39,Ohio
2020-06-26,OK,12343,298434,310777,40,Oklahoma
2020-06-26,OR,7818,209050,216868,41,Oregon
2020-06-26,PA,84370,634711,719081,42,Pennsylvania
2020-06-26,PR,6922,113280,120202,72,Puerto Rico
2020-06-26,RI,16777,133102,149879,44,Rhode Island
2020-06-26,SC,30335,304336,334671,45,South Carolina
2020-06-26,SD,6535,70480,77015,46,South Dakota
2020-06-26,TN,39444,702588,742032,47,Tennessee
2020-06-26,TX,137624,1559710,1697334,48,Texas
2020-06-26,UT,20050,297518,317568,49,Utah
2020-06-26,VA,60570,545893,606463,51,Virginia
2020-06-26,VI,81,2705,2786,78,U.S. Virgin Islands
2020-06-26,VT,1198,60391,61589,50,Vermont
2020-06-26,WA,30367,475428,505795,53,Washington
2020-06-26,WI,29668,507168,536836,55,Wisconsin
2020-06-26,WV,2712,159245,161957,54,West Virginia
2020-06-26,WY,1368,30406,31774,56,Wyoming
2020-06-25,AK,816,98636,99452,02,Alaska
2020-06-25,AL,33206,336252,369458,01,Alabama
2020-06-25,AR,18062,259318,277380,05,Arkansas
2020-06-25,AS,0,696,696,60,American Samoa
2020-06-25,AZ,63030,401166,464196,04,Arizona
2020-06-25,CA,195571,3498774,3694345,06,California
2020-06-25,CO,31155,264910,296065,08,Colorado
2020-06-25,CT,45994,371126,417120,09,Connecticut
2020-06-25,DC,10159,76572,86731,11,District of Columbia
2020-06-25,DE,10980,90012,100992,10,Delaware
2020-06-25,FL,114018,1606626,1720644,12,Florida
2020-06-25,GA,71095,686829,757924,13,Georgia
2020-06-25,GU,245,11173,11418,66,Guam
2020-06-25,HI,835,71100,71935,15,Hawaii
2020-06-25,IA,27197,249857,277054,19,Iowa
2020-06-25,ID,4645,75894,80539,16,Idaho
2020-06-25,IL,140434,1321093,1461527,17,Illinois
2020-06-25,IN,43655,400597,444252,18,Indiana
2020-06-25,KS,12970,148735,161705,20,Kansas
2020-06-25,KY,14617,328265,342882,21,Kentucky
2020-06-25,LA,53415,607250,660665,22,Louisiana
2020-06-25,MA,107837,697619,805456,25,Massachusetts
2020-06-25,MD,65777,433182,498959,24,Maryland
2020-06-25,ME,3070,84528,87598,23,Maine
2020-06-25,MI,68989,893850,962839,26,Michigan
2020-06-25,MN,34123,508573,542696,27,Minnesota
2020-06-25,MO,19421,322227,341648,29,Missouri
2020-06-25,MP,30,8187,8217,69,Northern Mariana Islands
2020-06-25,MS,24516,241481,265997,28,Mississippi
2020-06-25,MT,803,77529,78332,30,Montana
2020-06-25,NC,57183,754095,811278,37,North Carolina
2020-06-25,ND,3393,96051,99444,38,North Dakota
2020-06-25,NE,18221,144949,163170,31,Nebraska
2020-06-25,NH,5598,105968,111566,33,New Hampshire
2020-06-25,NJ,170196,1150714,1320910,34,New Jersey
2020-06-25,NM,10990,297115,308105,35,New Mexico
2020-06-25,NV,14859,240691,255550,32,Nevada
2020-06-25,NY,390415,3229179,3619594,36,New York
2020-06-25,OH,47651,651979,699630,39,Ohio
2020-06-25,OK,11948,293017,304965,40,Oklahoma
2020-06-25,OR,7568,209050,216618,41,Oregon
2020-06-25,PA,83770,621031,704801,42,Pennsylvania
2020-06-25,PR,6877,113280,120157,72,Puerto Rico
2020-06-25,RI,16708,131788,148496,44,Rhode Island
2020-06-25,SC,29022,304336,333358,45,South Carolina
2020-06-25,SD,6479,69375,75854,46,South Dakota
2020-06-25,TN,38034,689515,727549,47,Tennessee
2020-06-25,TX,131917,1527423,1659340,48,Texas
2020-06-25,UT,19374,292680,312054,49,Utah
2020-06-25,VA,59946,533020,592966,51,Virginia
2020-06-25,VI,80,2654,2734,78,U.S. Virgin Islands
2020-06-25,VT,1191,59518,60709,50,Vermont
2020-06-25,WA,29869,465629,495498,53,Washington
2020-06-25,WI,29105,498561,527666,55,Wisconsin
2020-06-25,WV,2661,156043,158704,54,West Virginia
2020-06-25,WY,1326,28869,30195,56,Wyoming
2020-06-24,AK,792,95304,96096,02,Alaska
2020-06-24,AL,32064,326695,358759,01,Alabama
2020-06-24,AR,17375,254491,271866,05,Arkansas
2020-06-24,AS,0,174,174,60,American Samoa
2020-06-24,AZ,59974,389214,449188,04,Arizona
2020-06-24,CA,190222,3402677,3592899,06,California
2020-06-24,CO,30893,259941,290834,08,Colorado
2020-06-24,CT,45913,363357,409270,09,Connecticut
2020-06-24,DC,10128,74045,84173,11,District of Columbia
2020-06-24,DE,10889,87312,98201,10,Delaware
2020-06-24,FL,109014,1559328,1668342,12,Florida
2020-06-24,GA,69381,673853,743234,13,Georgia
2020-06-24,GU,231,10807,11038,66,Guam
2020-06-24,HI,819,69720,70539,15,Hawaii
2020-06-24,IA,26705,243254,269959,19,Iowa
2020-06-24,ID,4402,73433,77835,16,Idaho
2020-06-24,IL,139540,1290301,1429841,17,Illinois
2020-06-24,IN,43140,388743,431883,18,Indiana
2020-06-24,KS,12970,148735,161705,20,Kansas
2020-06-24,KY,14363,321339,335702,21,Kentucky
2020-06-24,LA,52477,596028,648505,22,Louisiana
2020-06-24,MA,107611,687461,795072,25,Massachusetts
2020-06-24,MD,65337,425120,490457,24,Maryland
2020-06-24,ME,3017,82173,85190,23,Maine
2020-06-24,MI,68555,876250,944805,26,Michigan
2020-06-24,MN,33763,495880,529643,27,Minnesota
2020-06-24,MO,18868,308156,327024,29,Missouri
2020-06-24,MP,30,8187,8217,69,Northern Mariana Islands
2020-06-24,MS,23424,238237,261661,28,Mississippi
2020-06-24,MT,766,74300,75066,30,Montana
2020-06-24,NC,56174,735111,791285,37,North Carolina
2020-06-24,ND,3362,95327,98689,38,North Dakota
2020-06-24,NE,18092,143209,161301,31,Nebraska
2020-06-24,NH,5571,104482,110053,33,New Hampshire
2020-06-24,NJ,169892,1129753,1299645,34,New Jersey
2020-06-24,NM,10838,291245,302083,35,New Mexico
2020-06-24,NV,14362,238025,252387,32,Nevada
2020-06-24,NY,389666,3162286,3551952,36,New York
2020-06-24,OH,46759,633928,680687,39,Ohio
2020-06-24,OK,11510,286768,298278,40,Oklahoma
2020-06-24,OR,7444,206564,214008,41,Oregon
2020-06-24,PA,83191,608217,691408,42,Pennsylvania
2020-06-24,PR,6820,113280,120100,72,Puerto Rico
2020-06-24,RI,16663,130382,147045,44,Rhode Island
2020-06-24,SC,27897,290311,318208,45,South Carolina
2020-06-24,SD,6419,68658,75077,46,South Dakota
2020-06-24,TN,37235,681069,718304,47,Tennessee
2020-06-24,TX,125921,1504337,1630258,48,Texas
2020-06-24,UT,18784,285954,304738,49,Utah
2020-06-24,VA,59514,517057,576571,51,Virginia
2020-06-24,VI,78,2593,2671,78,U.S. Virgin Islands
2020-06-24,VT,1184,58676,59860,50,Vermont
2020-06-24,WA,29386,457673,487059,53,Washington
2020-06-24,WI,28641,487803,516444,55,Wisconsin
2020-06-24,WV,2629,154419,157048,54,West Virginia
2020-06-24,WY,1279,28869,30148,56,Wyoming
2020-06-23,AK,778,92169,92947,02,Alaska
2020-06-23,AL,31097,322941,354038,01,Alabama
2020-06-23,AR,16678,247814,264492,05,Arkansas
2020-06-23,AS,0,174,174,60,American Samoa
2020-06-23,AZ,58179,382339,440518,04,Arizona
2020-06-23,CA,183073,3313856,3496929,06,California
2020-06-23,CO,30705,257171,287876,08,Colorado
2020-06-23,CT,45899,356898,402797,09,Connecticut
2020-06-23,DC,10094,73208,83302,11,District of Columbia
2020-06-23,DE,10847,86689,97536,10,Delaware
2020-06-23,FL,103503,1537249,1640752,12,Florida
2020-06-23,GA,67678,663583,731261,13,Georgia
2020-06-23,GU,225,10426,10651,66,Guam
2020-06-23,HI,816,68524,69340,15,Hawaii
2020-06-23,IA,26373,238330,264703,19,Iowa
2020-06-23,ID,4254,71910,76164,16,Idaho
2020-06-23,IL,138825,1261685,1400510,17,Illinois
2020-06-23,IN,42871,383505,426376,18,Indiana
2020-06-23,KS,12465,142548,155013,20,Kansas
2020-06-23,KY,14141,317153,331294,21,Kentucky
2020-06-23,LA,51595,584344,635939,22,Louisiana
2020-06-23,MA,107439,680203,787642,25,Massachusetts
2020-06-23,MD,65007,418528,483535,24,Maryland
2020-06-23,ME,2994,78713,81707,23,Maine
2020-06-23,MI,68197,860471,928668,26,Michigan
2020-06-23,MN,33469,486576,520045,27,Minnesota
2020-06-23,MO,18143,299231,317374,29,Missouri
2020-06-23,MP,30,8187,8217,69,Northern Mariana Islands
2020-06-23,MS,22898,230962,253860,28,Mississippi
2020-06-23,MT,743,73180,73923,30,Montana
2020-06-23,NC,54453,719375,773828,37,North Carolina
2020-06-23,ND,3320,94233,97553,38,North Dakota
2020-06-23,NE,17957,140685,158642,31,Nebraska
2020-06-23,NH,5558,103318,108876,33,New Hampshire
2020-06-23,NJ,169734,1113717,1283451,34,New Jersey
2020-06-23,NM,10694,287382,298076,35,New Mexico
2020-06-23,NV,13997,234529,248526,32,Nevada
2020-06-23,NY,389085,3111723,3500808,36,New York
2020-06-23,OH,46127,624310,670437,39,Ohio
2020-06-23,OK,11028,284029,295057,40,Oklahoma
2020-06-23,OR,7274,203438,210712,41,Oregon
2020-06-23,PA,82696,596407,679103,42,Pennsylvania
2020-06-23,PR,6685,113280,119965,72,Puerto Rico
2020-06-23,RI,16612,128896,145508,44,Rhode Island
2020-06-23,SC,26613,282638,309251,45,South Carolina
2020-06-23,SD,6353,67633,73986,46,South Dakota
2020-06-23,TN,36303,669116,705419,47,Tennessee
2020-06-23,TX,120370,1476920,1597290,48,Texas
2020-06-23,UT,18300,283976,302276,49,Utah
2020-06-23,VA,58994,509383,568377,51,Virginia
2020-06-23,VI,76,2544,2620,78,U.S. Virgin Islands
2020-06-23,VT,1164,58164,59328,50,Vermont
2020-06-23,WA,28870,448334,477204,53,Washington
2020-06-23,WI,28175,478165,506340,55,Wisconsin
2020-06-23,WV,2582,151746,154328,54,West Virginia
2020-06-23,WY,1254,27485,28739,56,Wyoming
2020-06-22,AK,761,90063,90824,02,Alaska
2020-06-22,AL,30454,318656,349110,01,Alabama
2020-06-22,AR,16083,240256,256339,05,Arkansas
2020-06-22,AS,0,174,174,60,American Samoa
2020-06-22,AZ,54586,375204,429790,04,Arizona
2020-06-22,CA,178054,3233632,3411686,06,California
2020-06-22,CO,30539,252233,282772,08,Colorado
2020-06-22,CT,45782,358499,404281,09,Connecticut
2020-06-22,DC,10058,71946,82004,11,District of Columbia
2020-06-22,DE,10820,85903,96723,10,Delaware
2020-06-22,FL,100217,1517270,1617487,12,Florida
2020-06-22,GA,65928,642098,708026,13,Georgia
2020-06-22,GU,224,10180,10404,66,Guam
2020-06-22,HI,814,67897,68711,15,Hawaii
2020-06-22,IA,26051,232581,258632,19,Iowa
2020-06-22,ID,4006,68962,72968,16,Idaho
2020-06-22,IL,138224,1241779,1380003,17,Illinois
2020-06-22,IN,42633,376283,418916,18,Indiana
2020-06-22,KS,12465,142548,155013,20,Kansas
2020-06-22,KY,13839,308193,322032,21,Kentucky
2020-06-22,LA,50239,567825,618064,22,Louisiana
2020-06-22,MA,107210,672853,780063,25,Massachusetts
2020-06-22,MD,64603,410122,474725,24,Maryland
2020-06-22,ME,2971,78033,81004,23,Maine
2020-06-22,MI,67957,850060,918017,26,Michigan
2020-06-22,MN,33227,479910,513137,27,Minnesota
2020-06-22,MO,18143,299231,317374,29,Missouri
2020-06-22,MP,30,8139,8169,69,Northern Mariana Islands
2020-06-22,MS,22287,230962,253249,28,Mississippi
2020-06-22,MT,740,70565,71305,30,Montana
2020-06-22,NC,53605,703740,757345,37,North Carolina
2020-06-22,ND,3313,94140,97453,38,North Dakota
2020-06-22,NE,17810,138698,156508,31,Nebraska
2020-06-22,NH,5544,103318,108862,33,New Hampshire
2020-06-22,NJ,169415,1097984,1267399,34,New Jersey
2020-06-22,NM,10565,282866,293431,35,New Mexico
2020-06-22,NV,13535,230530,244065,32,Nevada
2020-06-22,NY,388488,3063611,3452099,36,New York
2020-06-22,OH,45537,614064,659601,39,Ohio
2020-06-22,OK,10733,271925,282658,40,Oklahoma
2020-06-22,OR,7083,199545,206628,41,Oregon
2020-06-22,PA,82186,585662,667848,42,Pennsylvania
2020-06-22,PR,6564,113280,119844,72,Puerto Rico
2020-06-22,RI,16535,127297,143832,44,Rhode Island
2020-06-22,SC,25701,278179,303880,45,South Carolina
2020-06-22,SD,6326,67003,73329,46,South Dakota
2020-06-22,TN,35553,664552,700105,47,Tennessee
2020-06-22,TX,114881,1434128,1549009,48,Texas
2020-06-22,UT,17906,281406,299312,49,Utah
2020-06-22,VA,58465,499658,558123,51,Virginia
2020-06-22,VI,76,2502,2578,78,U.S. Virgin Islands
2020-06-22,VT,1163,57444,58607,50,Vermont
2020-06-22,WA,28680,446258,474938,53,Washington
2020-06-22,WI,27878,466634,494512,55,Wisconsin
2020-06-22,WV,2552,148652,151204,54,West Virginia
2020-06-22,WY,1230,26162,27392,56,Wyoming
2020-06-21,AK,755,87296,88051,02,Alaska
2020-06-21,AL,30021,314657,344678,01,Alabama
2020-06-21,AR,15142,227092,242234,05,Arkansas
2020-06-21,AS,0,174,174,60,American Samoa
2020-06-21,AZ,52390,367354,419744,04,Arizona
2020-06-21,CA,173824,3145432,3319256,06,California
2020-06-21,CO,30349,248037,278386,08,Colorado
2020-06-21,CT,45755,352175,397930,09,Connecticut
2020-06-21,DC,10020,69502,79522,11,District of Columbia
2020-06-21,DE,10775,84199,94974,10,Delaware
2020-06-21,FL,97291,1502005,1599296,12,Florida
2020-06-21,GA,64701,633606,698307,13,Georgia
2020-06-21,GU,222,9788,10010,66,Guam
2020-06-21,HI,803,67057,67860,15,Hawaii
2020-06-21,IA,25963,231189,257152,19,Iowa
2020-06-21,ID,4006,68962,72968,16,Idaho
2020-06-21,IL,137762,1224022,1361784,17,Illinois
2020-06-21,IN,42423,369497,411920,18,Indiana
2020-06-21,KS,12059,135590,147649,20,Kansas
2020-06-21,KY,13750,303531,317281,21,Kentucky
2020-06-21,LA,49778,561034,610812,22,Louisiana
2020-06-21,MA,107061,666259,773320,25,Massachusetts
2020-06-21,MD,64306,404725,469031,24,Maryland
2020-06-21,ME,2957,78033,80990,23,Maine
2020-06-21,MI,67711,839715,907426,26,Michigan
2020-06-21,MN,32920,471443,504363,27,Minnesota
2020-06-21,MO,18003,297154,315157,29,Missouri
2020-06-21,MP,30,8139,8169,69,Northern Mariana Islands
2020-06-21,MS,20641,218074,238715,28,Mississippi
2020-06-21,MT,717,69640,70357,30,Montana
2020-06-21,NC,52801,692974,745775,37,North Carolina
2020-06-21,ND,3288,92885,96173,38,North Dakota
2020-06-21,NE,17707,136534,154241,31,Nebraska
2020-06-21,NH,5518,100367,105885,33,New Hampshire
2020-06-21,NJ,169142,1075825,1244967,34,New Jersey
2020-06-21,NM,10565,282866,293431,35,New Mexico
2020-06-21,NV,13205,228486,241691,32,Nevada
2020-06-21,NY,387936,3007383,3395319,36,New York
2020-06-21,OH,44808,598413,643221,39,Ohio
2020-06-21,OK,10515,271925,282440,40,Oklahoma
2020-06-21,OR,6937,195674,202611,41,Oregon
2020-06-21,PA,81730,576015,657745,42,Pennsylvania
2020-06-21,PR,6525,113280,119805,72,Puerto Rico
2020-06-21,RI,16476,125701,142177,44,Rhode Island
2020-06-21,SC,24693,277974,302667,45,South Carolina
2020-06-21,SD,6297,66729,73026,46,South Dakota
2020-06-21,TN,35102,650527,685629,47,Tennessee
2020-06-21,TX,111601,1414579,1526180,48,Texas
2020-06-21,UT,17462,278933,296395,49,Utah
2020-06-21,VA,57994,487682,545676,51,Virginia
2020-06-21,VI,76,2502,2578,78,U.S. Virgin Islands
2020-06-21,VT,1159,56686,57845,50,Vermont
2020-06-21,WA,28225,437844,466069,53,Washington
2020-06-21,WI,27615,460334,487949,55,Wisconsin
2020-06-21,WV,2543,148046,150589,54,West Virginia
2020-06-21,WY,1197,26162,27359,56,Wyoming
2020-06-20,AK,743,86175,86918,02,Alaska
2020-06-20,AL,29549,309974,339523,01,Alabama
2020-06-20,AR,15142,227092,242234,05,Arkansas
2020-06-20,AS,0,174,174,60,American Samoa
2020-06-20,AZ,49798,355482,405280,04,Arizona
2020-06-20,CA,169309,3065103,3234412,06,California
2020-06-20,CO,30187,242882,273069,08,Colorado
2020-06-20,CT,45715,350172,395887,09,Connecticut
2020-06-20,DC,9984,67969,77953,11,District of Columbia
2020-06-20,DE,10681,81735,92416,10,Delaware
2020-06-20,FL,93797,1467475,1561272,12,Florida
2020-06-20,GA,63809,630575,694384,13,Georgia
2020-06-20,GU,222,9788,10010,66,Guam
2020-06-20,HI,789,65945,66734,15,Hawaii
2020-06-20,IA,25496,224711,250207,19,Iowa
2020-06-20,ID,3871,67325,71196,16,Idaho
2020-06-20,IL,137104,1200864,1337968,17,Illinois
2020-06-20,IN,42061,359741,401802,18,Indiana
2020-06-20,KS,12059,135590,147649,20,Kansas
2020-06-20,KY,13630,303531,317161,21,Kentucky
2020-06-20,LA,49385,555431,604816,22,Louisiana
2020-06-20,MA,106936,658001,764937,25,Massachusetts
2020-06-20,MD,63956,398324,462280,24,Maryland
2020-06-20,ME,2938,76638,79576,23,Maine
2020-06-20,MI,67545,827089,894634,26,Michigan
2020-06-20,MN,32467,459576,492043,27,Minnesota
2020-06-20,MO,17590,293525,311115,29,Missouri
2020-06-20,MP,30,8139,8169,69,Northern Mariana Islands
2020-06-20,MS,20641,218074,238715,28,Mississippi
2020-06-20,MT,698,68832,69530,30,Montana
2020-06-20,NC,51389,679952,731341,37,North Carolina
2020-06-20,ND,3251,90980,94231,38,North Dakota
2020-06-20,NE,17591,134263,151854,31,Nebraska
2020-06-20,NH,5486,100081,105567,33,New Hampshire
2020-06-20,NJ,168834,1050039,1218873,34,New Jersey
2020-06-20,NM,10260,274342,284602,35,New Mexico
2020-06-20,NV,12931,226032,238963,32,Nevada
2020-06-20,NY,387272,2940521,3327793,36,New York
2020-06-20,OH,44262,585703,629965,39,Ohio
2020-06-20,OK,10037,271925,281962,40,Oklahoma
2020-06-20,OR,6750,187345,194095,41,Oregon
2020-06-20,PA,81266,566461,647727,42,Pennsylvania
2020-06-20,PR,6463,113280,119743,72,Puerto Rico
2020-06-20,RI,16449,125078,141527,44,Rhode Island
2020-06-20,SC,23786,272463,296249,45,South Carolina
2020-06-20,SD,6225,65690,71915,46,South Dakota
2020-06-20,TN,34446,640894,675340,47,Tennessee
2020-06-20,TX,107735,1355663,1463398,48,Texas
2020-06-20,UT,17068,275809,292877,49,Utah
2020-06-20,VA,57443,473961,531404,51,Virginia
2020-06-20,VI,74,2492,2566,78,U.S. Virgin Islands
2020-06-20,VT,1147,55881,57028,50,Vermont
2020-06-20,WA,28680,446471,475151,53,Washington
2020-06-20,WI,27326,454563,481889,55,Wisconsin
2020-06-20,WV,2486,145910,148396,54,West Virginia
2020-06-20,WY,1179,26162,27341,56,Wyoming
2020-06-19,AK,722,82909,83631,02,Alaska
2020-06-19,AL,29002,302323,331325,01,Alabama
2020-06-19,AR,14631,220141,234772,05,Arkansas
2020-06-19,AS,0,174,174,60,American Samoa
2020-06-19,AZ,46689,345527,392216,04,Arizona
2020-06-19,CA,165416,2990286,3155702,06,California
2020-06-19,CO,29901,234545,264446,08,Colorado
2020-06-19,CT,45557,346531,392088,09,Connecticut
2020-06-19,DC,9952,63839,73791,11,District of Columbia
2020-06-19,DE,10611,79823,90434,10,Delaware
2020-06-19,FL,89748,1443123,1532871,12,Florida
2020-06-19,GA,62009,608297,670306,13,Georgia
2020-06-19,GU,200,9515,9715,66,Guam
2020-06-19,HI,762,64982,65744,15,Hawaii
2020-06-19,IA,25275,221374,246649,19,Iowa
2020-06-19,ID,3743,65802,69545,16,Idaho
2020-06-19,IL,136470,1175533,1312003,17,Illinois
2020-06-19,IN,41746,351141,392887,18,Indiana
2020-06-19,KS,12059,135590,147649,20,Kansas
2020-06-19,KY,13454,297773,311227,21,Kentucky
2020-06-19,LA,48515,542394,590909,22,Louisiana
2020-06-19,MA,106650,644157,750807,25,Massachusetts
2020-06-19,MD,63548,390121,453669,24,Maryland
2020-06-19,ME,2913,74248,77161,23,Maine
2020-06-19,MI,67097,812831,879928,26,Michigan
2020-06-19,MN,32031,443121,475152,27,Minnesota
2020-06-19,MO,17201,289083,306284,29,Missouri
2020-06-19,MP,30,8139,8169,69,Northern Mariana Islands
2020-06-19,MS,20641,218074,238715,28,Mississippi
2020-06-19,MT,666,67756,68422,30,Montana
2020-06-19,NC,49840,662473,712313,37,North Carolina
2020-06-19,ND,3226,89380,92606,38,North Dakota
2020-06-19,NE,17415,130431,147846,31,Nebraska
2020-06-19,NH,5450,98275,103725,33,New Hampshire
2020-06-19,NJ,168496,1025847,1194343,34,New Jersey
2020-06-19,NM,10153,270022,280175,35,New Mexico
2020-06-19,NV,12486,221874,234360,32,Nevada
2020-06-19,NY,386556,2872407,3258963,36,New York
2020-06-19,OH,43731,572305,616036,39,Ohio
2020-06-19,OK,9706,264872,274578,40,Oklahoma
2020-06-19,OR,6572,187345,193917,41,Oregon
2020-06-19,PA,80762,556456,637218,42,Pennsylvania
2020-06-19,PR,6195,113280,119475,72,Puerto Rico
2020-06-19,RI,16413,124397,140810,44,Rhode Island
2020-06-19,SC,22631,265669,288300,45,South Carolina
2020-06-19,SD,6158,65035,71193,46,South Dakota
2020-06-19,TN,34017,627672,661689,47,Tennessee
2020-06-19,TX,103305,1320609,1423914,48,Texas
2020-06-19,UT,16425,270933,287358,49,Utah
2020-06-19,VA,56793,455618,512411,51,Virginia
2020-06-19,VI,74,2450,2524,78,U.S. Virgin Islands
2020-06-19,VT,1144,54743,55887,50,Vermont
2020-06-19,WA,28666,445796,474462,53,Washington
2020-06-19,WI,26913,444751,471664,55,Wisconsin
2020-06-19,WV,2435,143579,146014,54,West Virginia
2020-06-19,WY,1173,35301,36474,56,Wyoming
2020-06-18,AK,708,80477,81185,02,Alaska
2020-06-18,AL,28206,294328,322534,01,Alabama
2020-06-18,AR,13928,214506,228434,05,Arkansas
2020-06-18,AS,0,174,174,60,American Samoa
2020-06-18,AZ,43443,336289,379732,04,Arizona
2020-06-18,CA,161099,2913431,3074530,06,California
2020-06-18,CO,29673,232543,262216,08,Colorado
2020-06-18,CT,45440,334853,380293,09,Connecticut
2020-06-18,DC,9903,62296,72199,11,District of Columbia
2020-06-18,DE,10499,78185,88684,10,Delaware
2020-06-18,FL,85926,1425386,1511312,12,Florida
2020-06-18,GA,60912,602292,663204,13,Georgia
2020-06-18,GU,193,9395,9588,66,Guam
2020-06-18,HI,744,63630,64374,15,Hawaii
2020-06-18,IA,24854,216077,240931,19,Iowa
2020-06-18,ID,3632,64380,68012,16,Idaho
2020-06-18,IL,135639,1149054,1284693,17,Illinois
2020-06-18,IN,41438,343284,384722,18,Indiana
2020-06-18,KS,11681,130443,142124,20,Kansas
2020-06-18,KY,13197,293183,306380,21,Kentucky
2020-06-18,LA,48634,496587,545221,22,Louisiana
2020-06-18,MA,106422,634838,741260,25,Massachusetts
2020-06-18,MD,63229,384379,447608,24,Maryland
2020-06-18,ME,2878,71182,74060,23,Maine
2020-06-18,MI,66798,783388,850186,26,Michigan
2020-06-18,MN,31675,429204,460879,27,Minnesota
2020-06-18,MO,16908,280434,297342,29,Missouri
2020-06-18,MP,30,8139,8169,69,Northern Mariana Islands
2020-06-18,MS,20641,218074,238715,28,Mississippi
2020-06-18,MT,655,66215,66870,30,Montana
2020-06-18,NC,48188,645490,693678,37,North Carolina
2020-06-18,ND,3193,87461,90654,38,North Dakota
2020-06-18,NE,17226,127587,144813,31,Nebraska
2020-06-18,NH,5436,96548,101984,33,New Hampshire
2020-06-18,NJ,168107,1003627,1171734,34,New Jersey
2020-06-18,NM,10065,265832,275897,35,New Mexico
2020-06-18,NV,12076,218720,230796,32,Nevada
2020-06-18,NY,385760,2793900,3179660,36,New York
2020-06-18,OH,43122,556902,600024,39,Ohio
2020-06-18,OK,9354,260199,269553,40,Oklahoma
2020-06-18,OR,6366,182770,189136,41,Oregon
2020-06-18,PA,80236,543832,624068,42,Pennsylvania
2020-06-18,PR,6111,113280,119391,72,Puerto Rico
2020-06-18,RI,16354,123216,139570,44,Rhode Island
2020-06-18,SC,21548,258975,280523,45,South Carolina
2020-06-18,SD,6109,64244,70353,46,South Dakota
2020-06-18,TN,32829,619565,652394,47,Tennessee
2020-06-18,TX,99851,1307890,1407741,48,Texas
2020-06-18,UT,15839,266846,282685,49,Utah
2020-06-18,VA,56238,445830,502068,51,Virginia
2020-06-18,VI,73,2354,2427,78,U.S. Virgin Islands
2020-06-18,VT,1135,53610,54745,50,Vermont
2020-06-18,WA,28575,441468,470043,53,Washington
2020-06-18,WI,26590,433913,460503,55,Wisconsin
2020-06-18,WV,2418,142011,144429,54,West Virginia
2020-06-18,WY,1144,35010,36154,56,Wyoming
2020-06-17,AK,696,77013,77709,02,Alaska
2020-06-17,AL,27312,283411,310723,01,Alabama
2020-06-17,AR,13606,207093,220699,05,Arkansas
2020-06-17,AS,0,174,174,60,American Samoa
2020-06-17,AZ,40924,325269,366193,04,Arizona
2020-06-17,CA,157015,2840973,2997988,06,California
2020-06-17,CO,29442,227225,256667,08,Colorado
2020-06-17,CT,45429,327850,373279,09,Connecticut
2020-06-17,DC,9847,60239,70086,11,District of Columbia
2020-06-17,DE,10444,76143,86587,10,Delaware
2020-06-17,FL,82719,1403040,1485759,12,Florida
2020-06-17,GA,60030,590437,650467,13,Georgia
2020-06-17,GU,188,9010,9198,66,Guam
2020-06-17,HI,740,62503,63243,15,Hawaii
2020-06-17,IA,24461,210670,235131,19,Iowa
2020-06-17,ID,3540,63244,66784,16,Idaho
2020-06-17,IL,135046,1124143,1259189,17,Illinois
2020-06-17,IN,41013,330169,371182,18,Indiana
2020-06-17,KS,11681,130443,142124,20,Kansas
2020-06-17,KY,12995,286874,299869,21,Kentucky
2020-06-17,LA,48634,496587,545221,22,Louisiana
2020-06-17,MA,106151,625895,732046,25,Massachusetts
2020-06-17,MD,62969,378374,441343,24,Maryland
2020-06-17,ME,2836,71182,74018,23,Maine
2020-06-17,MI,66497,783388,849885,26,Michigan
2020-06-17,MN,31296,417291,448587,27,Minnesota
2020-06-17,MO,16625,268377,285002,29,Missouri
2020-06-17,MP,30,8139,8169,69,Northern Mariana Islands
2020-06-17,MS,20641,223748,244389,28,Mississippi
2020-06-17,MT,630,64885,65515,30,Montana
2020-06-17,NC,46855,620567,667422,37,North Carolina
2020-06-17,ND,3166,86508,89674,38,North Dakota
2020-06-17,NE,17031,125356,142387,31,Nebraska
2020-06-17,NH,5364,94722,100086,33,New Hampshire
2020-06-17,NJ,167703,980138,1147841,34,New Jersey
2020-06-17,NM,9933,261620,271553,35,New Mexico
2020-06-17,NV,11842,215768,227610,32,Nevada
2020-06-17,NY,385142,2725977,3111119,36,New York
2020-06-17,OH,42422,542141,584563,39,Ohio
2020-06-17,OK,8904,256528,265432,40,Oklahoma
2020-06-17,OR,6218,178132,184350,41,Oregon
2020-06-17,PA,79818,533013,612831,42,Pennsylvania
2020-06-17,PR,6003,113280,119283,72,Puerto Rico
2020-06-17,RI,16283,121997,138280,44,Rhode Island
2020-06-17,SC,20556,252198,272754,45,South Carolina
2020-06-17,SD,6050,62938,68988,46,South Dakota
2020-06-17,TN,32143,612430,644573,47,Tennessee
2020-06-17,TX,96335,1273303,1369638,48,Texas
2020-06-17,UT,15344,263348,278692,49,Utah
2020-06-17,VA,55775,438566,494341,51,Virginia
2020-06-17,VI,73,2354,2427,78,U.S. Virgin Islands
2020-06-17,VT,1130,52533,53663,50,Vermont
2020-06-17,WA,28255,435169,463424,53,Washington
2020-06-17,WI,26129,423736,449865,55,Wisconsin
2020-06-17,WV,2376,138994,141370,54,West Virginia
2020-06-17,WY,1114,33955,35069,56,Wyoming
2020-06-16,AK,676,75539,76215,02,Alaska
2020-06-16,AL,26912,278512,305424,01,Alabama
2020-06-16,AR,13191,192375,205566,05,Arkansas
2020-06-16,AS,0,174,174,60,American Samoa
2020-06-16,AZ,39097,315237,354334,04,Arizona
2020-06-16,CA,153560,2784195,2937755,06,California
2020-06-16,CO,29299,223857,253156,08,Colorado
2020-06-16,CT,45349,323359,368708,09,Connecticut
2020-06-16,DC,9818,57308,67126,11,District of Columbia
2020-06-16,DE,10403,75671,86074,10,Delaware
2020-06-16,FL,80109,1380200,1460309,12,Florida
2020-06-16,GA,59078,575900,634978,13,Georgia
2020-06-16,GU,186,8846,9032,66,Guam
2020-06-16,HI,736,61292,62028,15,Hawaii
2020-06-16,IA,24179,206459,230638,19,Iowa
2020-06-16,ID,3462,62185,65647,16,Idaho
2020-06-16,IL,134500,1094702,1229202,17,Illinois
2020-06-16,IN,40786,322959,363745,18,Indiana
2020-06-16,KS,11419,125543,136962,20,Kansas
2020-06-16,KY,12829,283204,296033,21,Kentucky
2020-06-16,LA,47706,485011,532717,22,Louisiana
2020-06-16,MA,105885,617762,723647,25,Massachusetts
2020-06-16,MD,62409,366816,429225,24,Maryland
2020-06-16,ME,2819,69516,72335,23,Maine
2020-06-16,MI,66269,769265,835534,26,Michigan
2020-06-16,MN,30882,398263,429145,27,Minnesota
2020-06-16,MO,16414,268377,284791,29,Missouri
2020-06-16,MP,30,8139,8169,69,Northern Mariana Islands
2020-06-16,MS,20152,220651,240803,28,Mississippi
2020-06-16,MT,614,62963,63577,30,Montana
2020-06-16,NC,45853,605568,651421,37,North Carolina
2020-06-16,ND,3124,85527,88651,38,North Dakota
2020-06-16,NE,16851,122662,139513,31,Nebraska
2020-06-16,NH,5345,93528,98873,33,New Hampshire
2020-06-16,NJ,167426,964356,1131782,34,New Jersey
2020-06-16,NM,9845,258076,267921,35,New Mexico
2020-06-16,NV,11658,210816,222474,32,Nevada
2020-06-16,NY,384575,2667203,3051778,36,New York
2020-06-16,OH,42010,526123,568133,39,Ohio
2020-06-16,OK,8645,253160,261805,40,Oklahoma
2020-06-16,OR,6098,173440,179538,41,Oregon
2020-06-16,PA,79483,523609,603092,42,Pennsylvania
2020-06-16,PR,5951,113280,119231,72,Puerto Rico
2020-06-16,RI,16232,120790,137022,44,Rhode Island
2020-06-16,SC,19990,247689,267679,45,South Carolina
2020-06-16,SD,5966,61236,67202,46,South Dakota
2020-06-16,TN,31830,607160,638990,47,Tennessee
2020-06-16,TX,93206,1255236,1348442,48,Texas
2020-06-16,UT,14937,260763,275700,49,Utah
2020-06-16,VA,55331,430107,485438,51,Virginia
2020-06-16,VI,73,2305,2378,78,U.S. Virgin Islands
2020-06-16,VT,1131,51759,52890,50,Vermont
2020-06-16,WA,27925,426586,454511,53,Washington
2020-06-16,WI,25844,414330,440174,55,Wisconsin
2020-06-16,WV,2341,134730,137071,54,West Virginia
2020-06-16,WY,1089,33324,34413,56,Wyoming
2020-06-15,AK,664,73773,74437,02,Alaska
2020-06-15,AL,26272,276402,302674,01,Alabama
2020-06-15,AR,12917,191221,204138,05,Arkansas
2020-06-15,AS,0,174,174,60,American Samoa
2020-06-15,AZ,36705,308552,345257,04,Arizona
2020-06-15,CA,151452,2716730,2868182,06,California
2020-06-15,CO,29130,219955,249085,08,Colorado
2020-06-15,CT,45235,317038,362273,09,Connecticut
2020-06-15,DC,9799,56047,65846,11,District of Columbia
2020-06-15,DE,10340,74346,84686,10,Delaware
2020-06-15,FL,77326,1352858,1430184,12,Florida
2020-06-15,GA,58414,572082,630496,13,Georgia
2020-06-15,GU,185,8573,8758,66,Guam
2020-06-15,HI,728,60746,61474,15,Hawaii
2020-06-15,IA,24053,203335,227388,19,Iowa
2020-06-15,ID,3399,59581,62980,16,Idaho
2020-06-15,IL,133877,1076596,1210473,17,Illinois
2020-06-15,IN,40430,315399,355829,18,Indiana
2020-06-15,KS,11419,125543,136962,20,Kansas
2020-06-15,KY,12647,283204,295851,21,Kentucky
2020-06-15,LA,47172,471553,518725,22,Louisiana
2020-06-15,MA,105690,611541,717231,25,Massachusetts
2020-06-15,MD,62032,359076,421108,24,Maryland
2020-06-15,ME,2810,68161,70971,23,Maine
2020-06-15,MI,66085,757952,824037,26,Michigan
2020-06-15,MN,30693,392229,422922,27,Minnesota
2020-06-15,MO,16189,263752,279941,29,Missouri
2020-06-15,MP,30,8139,8169,69,Northern Mariana Islands
2020-06-15,MS,19799,210704,230503,28,Mississippi
2020-06-15,MT,609,60328,60937,30,Montana
2020-06-15,NC,45102,593377,638479,37,North Carolina
2020-06-15,ND,3101,84675,87776,38,North Dakota
2020-06-15,NE,16725,121030,137755,31,Nebraska
2020-06-15,NH,5345,93528,98873,33,New Hampshire
2020-06-15,NJ,167103,948980,1116083,34,New Jersey
2020-06-15,NM,9723,253942,263665,35,New Mexico
2020-06-15,NV,11279,205155,216434,32,Nevada
2020-06-15,NY,383944,2607266,2991210,36,New York
2020-06-15,OH,41576,515592,557168,39,Ohio
2020-06-15,OK,8417,242587,251004,40,Oklahoma
2020-06-15,OR,5820,170316,176136,41,Oregon
2020-06-15,PA,79121,513909,593030,42,Pennsylvania
2020-06-15,PR,5890,113280,119170,72,Puerto Rico
2020-06-15,RI,16180,119304,135484,44,Rhode Island
2020-06-15,SC,19378,236179,255557,45,South Carolina
2020-06-15,SD,5928,60467,66395,46,South Dakota
2020-06-15,TN,31160,598818,629978,47,Tennessee
2020-06-15,TX,89108,1225653,1314761,48,Texas
2020-06-15,UT,14608,258330,272938,49,Utah
2020-06-15,VA,54886,424113,478999,51,Virginia
2020-06-15,VI,73,2305,2378,78,U.S. Virgin Islands
2020-06-15,VT,1128,51429,52557,50,Vermont
2020-06-15,WA,27493,416076,443569,53,Washington
2020-06-15,WI,25546,403447,428993,55,Wisconsin
2020-06-15,WV,2298,129655,131953,54,West Virginia
2020-06-15,WY,1060,31546,32606,56,Wyoming
2020-06-14,AK,661,72806,73467,02,Alaska
2020-06-14,AL,25615,271840,297455,01,Alabama
2020-06-14,AR,12501,184488,196989,05,Arkansas
2020-06-14,AS,0,174,174,60,American Samoa
2020-06-14,AZ,35691,302354,338045,04,Arizona
2020-06-14,CA,148855,2653141,2801996,06,California
2020-06-14,CO,29017,215626,244643,08,Colorado
2020-06-14,CT,45088,312263,357351,09,Connecticut
2020-06-14,DC,9767,54763,64530,11,District of Columbia
2020-06-14,DE,10264,71523,81787,10,Delaware
2020-06-14,FL,75568,1333447,1409015,12,Florida
2020-06-14,GA,57681,563109,620790,13,Georgia
2020-06-14,GU,185,8358,8543,66,Guam
2020-06-14,HI,723,59599,60322,15,Hawaii
2020-06-14,IA,23926,200708,224634,19,Iowa
2020-06-14,ID,3399,59581,62980,16,Idaho
2020-06-14,IL,133404,1058442,1191846,17,Illinois
2020-06-14,IN,39909,308482,348391,18,Indiana
2020-06-14,KS,11047,118105,129152,20,Kansas
2020-06-14,KY,12445,282140,294585,21,Kentucky
2020-06-14,LA,46619,462713,509332,22,Louisiana
2020-06-14,MA,105603,607107,712710,25,Massachusetts
2020-06-14,MD,61701,353608,415309,24,Maryland
2020-06-14,ME,2793,67065,69858,23,Maine
2020-06-14,MI,66054,747444,813498,26,Michigan
2020-06-14,MN,30471,387239,417710,27,Minnesota
2020-06-14,MO,15810,259679,275489,29,Missouri
2020-06-14,MP,30,8139,8169,69,Northern Mariana Islands
2020-06-14,MS,19516,194537,214053,28,Mississippi
2020-06-14,MT,601,58306,58907,30,Montana
2020-06-14,NC,44119,583011,627130,37,North Carolina
2020-06-14,ND,3080,83800,86880,38,North Dakota
2020-06-14,NE,16633,119482,136115,31,Nebraska
2020-06-14,NH,5299,91122,96421,33,New Hampshire
2020-06-14,NJ,166881,930735,1097616,34,New Jersey
2020-06-14,NM,9621,249373,258994,35,New Mexico
2020-06-14,NV,11173,199438,210611,32,Nevada
2020-06-14,NY,383324,2551275,2934599,36,New York
2020-06-14,OH,41148,505072,546220,39,Ohio
2020-06-14,OK,8231,242587,250818,40,Oklahoma
2020-06-14,OR,5636,168246,173882,41,Oregon
2020-06-14,PA,78798,504435,583233,42,Pennsylvania
2020-06-14,PR,5811,113280,119091,72,Puerto Rico
2020-06-14,RI,16104,117593,133697,44,Rhode Island
2020-06-14,SC,18795,229541,248336,45,South Carolina
2020-06-14,SD,5898,59421,65319,46,South Dakota
2020-06-14,TN,30432,584788,615220,47,Tennessee
2020-06-14,TX,87854,1208129,1295983,48,Texas
2020-06-14,UT,14313,253400,267713,49,Utah
2020-06-14,VA,54506,414494,469000,51,Virginia
2020-06-14,VI,72,2305,2377,78,U.S. Virgin Islands
2020-06-14,VT,1127,49855,50982,50,Vermont
2020-06-14,WA,27095,405799,432894,53,Washington
2020-06-14,WI,25340,397366,422706,55,Wisconsin
2020-06-14,WV,2289,128910,131199,54,West Virginia
2020-06-14,WY,1060,32005,33065,56,Wyoming
2020-06-13,AK,654,71149,71803,02,Alaska
2020-06-13,AL,24601,268651,293252,01,Alabama
2020-06-13,AR,11547,175470,187017,05,Arkansas
2020-06-13,AS,0,174,174,60,American Samoa
2020-06-13,AZ,34458,293939,328397,04,Arizona
2020-06-13,CA,145643,2578750,2724393,06,California
2020-06-13,CO,28822,207639,236461,08,Colorado
2020-06-13,CT,44994,305173,350167,09,Connecticut
2020-06-13,DC,9709,53327,63036,11,District of Columbia
2020-06-13,DE,10229,69870,80099,10,Delaware
2020-06-13,FL,73552,1296861,1370413,12,Florida
2020-06-13,GA,56801,542879,599680,13,Georgia
2020-06-13,GU,185,8358,8543,66,Guam
2020-06-13,HI,706,58632,59338,15,Hawaii
2020-06-13,IA,23717,195891,219608,19,Iowa
2020-06-13,ID,3353,59305,62658,16,Idaho
2020-06-13,IL,132732,1037074,1169806,17,Illinois
2020-06-13,IN,39543,301094,340637,18,Indiana
2020-06-13,KS,11047,118105,129152,20,Kansas
2020-06-13,KY,12445,282140,294585,21,Kentucky
2020-06-13,LA,46283,458100,504383,22,Louisiana
2020-06-13,MA,105395,598201,703596,25,Massachusetts
2020-06-13,MD,61305,347453,408758,24,Maryland
2020-06-13,ME,2757,65593,68350,23,Maine
2020-06-13,MI,65836,733647,799483,26,Michigan
2020-06-13,MN,30465,387245,417710,27,Minnesota
2020-06-13,MO,15810,253986,269796,29,Missouri
2020-06-13,MP,30,7906,7936,69,Northern Mariana Islands
2020-06-13,MS,19348,194537,213885,28,Mississippi
2020-06-13,MT,588,57416,58004,30,Montana
2020-06-13,NC,42676,569014,611690,37,North Carolina
2020-06-13,ND,3058,82815,85873,38,North Dakota
2020-06-13,NE,16513,117864,134377,31,Nebraska
2020-06-13,NH,5251,88705,93956,33,New Hampshire
2020-06-13,NJ,166605,911610,1078215,34,New Jersey
2020-06-13,NM,9526,245758,255284,35,New Mexico
2020-06-13,NV,10946,193934,204880,32,Nevada
2020-06-13,NY,382630,2489610,2872240,36,New York
2020-06-13,OH,40848,498050,538898,39,Ohio
2020-06-13,OK,8073,238366,246439,40,Oklahoma
2020-06-13,OR,5535,164944,170479,41,Oregon
2020-06-13,PA,78462,496589,575051,42,Pennsylvania
2020-06-13,PR,5690,113280,118970,72,Puerto Rico
2020-06-13,RI,16072,116709,132781,44,Rhode Island
2020-06-13,SC,17955,223951,241906,45,South Carolina
2020-06-13,SD,5833,58680,64513,46,South Dakota
2020-06-13,TN,29541,571821,601362,47,Tennessee
2020-06-13,TX,86011,1174308,1260319,48,Texas
2020-06-13,UT,13981,248801,262782,49,Utah
2020-06-13,VA,53869,406124,459993,51,Virginia
2020-06-13,VI,72,2284,2356,78,U.S. Virgin Islands
2020-06-13,VT,1125,48808,49933,50,Vermont
2020-06-13,WA,26985,402149,429134,53,Washington
2020-06-13,WI,25089,388399,413488,55,Wisconsin
2020-06-13,WV,2259,125258,127517,54,West Virginia
2020-06-13,WY,1050,32005,33055,56,Wyoming
2020-06-12,AK,625,70255,70880,02,Alaska
2020-06-12,AL,23710,262675,286385,01,Alabama
2020-06-12,AR,11547,169575,181122,05,Arkansas
2020-06-12,AS,0,174,174,60,American Samoa
2020-06-12,AZ,32918,289861,322779,04,Arizona
2020-06-12,CA,141983,2520275,2662258,06,California
2020-06-12,CO,28647,205723,234370,08,Colorado
2020-06-12,CT,44689,300443,345132,09,Connecticut
2020-06-12,DC,9654,52299,61953,11,District of Columbia
2020-06-12,DE,10173,67521,77694,10,Delaware
2020-06-12,FL,70971,1264928,1335899,12,Florida
2020-06-12,GA,55783,536175,591958,13,Georgia
2020-06-12,GU,184,8343,8527,66,Guam
2020-06-12,HI,692,57887,58579,15,Hawaii
2020-06-12,IA,23337,191207,214544,19,Iowa
2020-06-12,ID,3302,58130,61432,16,Idaho
2020-06-12,IL,132059,1015903,1147962,17,Illinois
2020-06-12,IN,39146,296034,335180,18,Indiana
2020-06-12,KS,11047,118105,129152,20,Kansas
2020-06-12,KY,11945,269149,281094,21,Kentucky
2020-06-12,LA,44995,434539,479534,22,Louisiana
2020-06-12,MA,105059,588300,693359,25,Massachusetts
2020-06-12,MD,60613,339482,400095,24,Maryland
2020-06-12,ME,2721,64166,66887,23,Maine
2020-06-12,MI,65672,720615,786287,26,Michigan
2020-06-12,MN,30463,377589,408052,27,Minnesota
2020-06-12,MO,15585,249550,265135,29,Missouri
2020-06-12,MP,30,7732,7762,69,Northern Mariana Islands
2020-06-12,MS,19091,195402,214493,28,Mississippi
2020-06-12,MT,573,56449,57022,30,Montana
2020-06-12,NC,41249,554448,595697,37,North Carolina
2020-06-12,ND,3016,81148,84164,38,North Dakota
2020-06-12,NE,16315,114458,130773,31,Nebraska
2020-06-12,NH,5209,86708,91917,33,New Hampshire
2020-06-12,NJ,166164,889232,1055396,34,New Jersey
2020-06-12,NM,9526,245758,255284,35,New Mexico
2020-06-12,NV,10678,188769,199447,32,Nevada
2020-06-12,NY,381714,2419686,2801400,36,New York
2020-06-12,OH,40424,483294,523718,39,Ohio
2020-06-12,OK,7848,238366,246214,40,Oklahoma
2020-06-12,OR,5377,160812,166189,41,Oregon
2020-06-12,PA,77999,488385,566384,42,Pennsylvania
2020-06-12,PR,5536,113280,118816,72,Puerto Rico
2020-06-12,RI,16023,115483,131506,44,Rhode Island
2020-06-12,SC,17170,218889,236059,45,South Carolina
2020-06-12,SD,5742,57263,63005,46,South Dakota
2020-06-12,TN,29126,561047,590173,47,Tennessee
2020-06-12,TX,83680,1143277,1226957,48,Texas
2020-06-12,UT,13577,245209,258786,49,Utah
2020-06-12,VA,53211,397319,450530,51,Virginia
2020-06-12,VI,72,2221,2293,78,U.S. Virgin Islands
2020-06-12,VT,1119,47515,48634,50,Vermont
2020-06-12,WA,26825,396220,423045,53,Washington
2020-06-12,WI,24795,377362,402157,55,Wisconsin
2020-06-12,WV,2233,121806,124039,54,West Virginia
2020-06-12,WY,1027,30873,31900,56,Wyoming
2020-06-11,AK,611,68400,69011,02,Alaska
2020-06-11,AL,22845,255981,278826,01,Alabama
2020-06-11,AR,10816,165849,176665,05,Arkansas
2020-06-11,AS,0,174,174,60,American Samoa
2020-06-11,AZ,31264,278318,309582,04,Arizona
2020-06-11,CA,139281,2458366,2597647,06,California
2020-06-11,CO,28499,201846,230345,08,Colorado
2020-06-11,CT,44461,286610,331071,09,Connecticut
2020-06-11,DC,9589,49699,59288,11,District of Columbia
2020-06-11,DE,10106,63927,74033,10,Delaware
2020-06-11,FL,69069,1237679,1306748,12,Florida
2020-06-11,GA,54973,529268,584241,13,Georgia
2020-06-11,GU,183,8197,8380,66,Guam
2020-06-11,HI,685,56610,57295,15,Hawaii
2020-06-11,IA,22938,185601,208539,19,Iowa
2020-06-11,ID,3260,56855,60115,16,Idaho
2020-06-11,IL,131327,991724,1123051,17,Illinois
2020-06-11,IN,38748,288594,327342,18,Indiana
2020-06-11,KS,10812,112930,123742,20,Kansas
2020-06-11,KY,11945,269149,281094,21,Kentucky
2020-06-11,LA,44472,425201,469673,22,Louisiana
2020-06-11,MA,104667,578421,683088,25,Massachusetts
2020-06-11,MD,60197,332173,392370,24,Maryland
2020-06-11,ME,2667,62790,65457,23,Maine
2020-06-11,MI,65449,705071,770520,26,Michigan
2020-06-11,MN,30418,364816,395234,27,Minnesota
2020-06-11,MO,15390,243650,259040,29,Missouri
2020-06-11,MP,30,7551,7581,69,Northern Mariana Islands
2020-06-11,MS,18483,195402,213885,28,Mississippi
2020-06-11,MT,563,55214,55777,30,Montana
2020-06-11,NC,39481,533196,572677,37,North Carolina
2020-06-11,ND,2980,79808,82788,38,North Dakota
2020-06-11,NE,16025,111637,127662,31,Nebraska
2020-06-11,NH,5178,84729,89907,33,New Hampshire
2020-06-11,NJ,165816,864977,1030793,34,New Jersey
2020-06-11,NM,9250,236307,245557,35,New Mexico
2020-06-11,NV,10399,182855,193254,32,Nevada
2020-06-11,NY,380892,2348113,2729005,36,New York
2020-06-11,OH,40004,472579,512583,39,Ohio
2020-06-11,OK,7626,233819,241445,40,Oklahoma
2020-06-11,OR,5237,156567,161804,41,Oregon
2020-06-11,PA,77933,476439,554372,42,Pennsylvania
2020-06-11,PR,5352,88685,94037,72,Puerto Rico
2020-06-11,RI,15942,113390,129332,44,Rhode Island
2020-06-11,SC,16441,213616,230057,45,South Carolina
2020-06-11,SD,5665,56079,61744,46,South Dakota
2020-06-11,TN,28538,506756,535294,47,Tennessee
2020-06-11,TX,81583,1124737,1206320,48,Texas
2020-06-11,UT,13252,241416,254668,49,Utah
2020-06-11,VA,52647,354750,407397,51,Virginia
2020-06-11,VI,72,2180,2252,78,U.S. Virgin Islands
2020-06-11,VT,1110,46099,47209,50,Vermont
2020-06-11,WA,26559,387295,413854,53,Washington
2020-06-11,WI,24441,366054,390495,55,Wisconsin
2020-06-11,WV,2212,118908,121120,54,West Virginia
2020-06-11,WY,1009,30609,31618,56,Wyoming
2020-06-10,AK,593,67127,67720,02,Alaska
2020-06-10,AL,21989,251068,273057,01,Alabama
2020-06-10,AR,10368,165849,176217,05,Arkansas
2020-06-10,AS,0,174,174,60,American Samoa
2020-06-10,AZ,29852,269835,299687,04,Arizona
2020-06-10,CA,136191,2404607,2540798,06,California
2020-06-10,CO,28347,197747,226094,08,Colorado
2020-06-10,CT,44347,278657,323004,09,Connecticut
2020-06-10,DC,9537,48655,58192,11,District of Columbia
2020-06-10,DE,10056,61689,71745,10,Delaware
2020-06-10,FL,67371,1211652,1279023,12,Florida
2020-06-10,GA,53980,516975,570955,13,Georgia
2020-06-10,GU,182,8100,8282,66,Guam
2020-06-10,HI,682,55491,56173,15,Hawaii
2020-06-10,IA,22551,180278,202829,19,Iowa
2020-06-10,ID,3220,55832,59052,16,Idaho
2020-06-10,IL,130561,970165,1100726,17,Illinois
2020-06-10,IN,38337,281757,320094,18,Indiana
2020-06-10,KS,10812,112930,123742,20,Kansas
2020-06-10,KY,11883,262531,274414,21,Kentucky
2020-06-10,LA,44030,416090,460120,22,Louisiana
2020-06-10,MA,104156,567934,672090,25,Massachusetts
2020-06-10,MD,59465,325177,384642,24,Maryland
2020-06-10,ME,2637,61303,63940,23,Maine
2020-06-10,MI,65182,690869,756051,26,Michigan
2020-06-10,MN,30199,351634,381833,27,Minnesota
2020-06-10,MO,15187,236442,251629,29,Missouri
2020-06-10,MP,30,7493,7523,69,Northern Mariana Islands
2020-06-10,MS,18483,195402,213885,28,Mississippi
2020-06-10,MT,561,54055,54616,30,Montana
2020-06-10,NC,38171,515479,553650,37,North Carolina
2020-06-10,ND,2941,78719,81660,38,North Dakota
2020-06-10,NE,15883,109279,125162,31,Nebraska
2020-06-10,NH,5132,83515,88647,33,New Hampshire
2020-06-10,NJ,165346,843588,1008934,34,New Jersey
2020-06-10,NM,9105,232552,241657,35,New Mexico
2020-06-10,NV,10164,177159,187323,32,Nevada
2020-06-10,NY,380156,2288010,2668166,36,New York
2020-06-10,OH,39575,462309,501884,39,Ohio
2020-06-10,OK,7480,229817,237297,40,Oklahoma
2020-06-10,OR,5060,151698,156758,41,Oregon
2020-06-10,PA,77466,466964,544430,42,Pennsylvania
2020-06-10,PR,5329,88685,94014,72,Puerto Rico
2020-06-10,RI,15855,111952,127807,44,Rhode Island
2020-06-10,SC,15759,236773,252532,45,South Carolina
2020-06-10,SD,5604,55081,60685,46,South Dakota
2020-06-10,TN,28061,500766,528827,47,Tennessee
2020-06-10,TX,79757,1081330,1161087,48,Texas
2020-06-10,UT,12864,236896,249760,49,Utah
2020-06-10,VA,52177,346187,398364,51,Virginia
2020-06-10,VI,72,2169,2241,78,U.S. Virgin Islands
2020-06-10,VT,1095,44647,45742,50,Vermont
2020-06-10,WA,26281,376364,402645,53,Washington
2020-06-10,WI,24070,357112,381182,55,Wisconsin
2020-06-10,WV,2188,115802,117990,54,West Virginia
2020-06-10,WY,980,29872,30852,56,Wyoming
2020-06-09,AK,573,66317,66890,02,Alaska
2020-06-09,AL,21422,246317,267739,01,Alabama
2020-06-09,AR,10080,155701,165781,05,Arkansas
2020-06-09,AS,0,174,174,60,American Samoa
2020-06-09,AZ,28296,264917,293213,04,Arizona
2020-06-09,CA,133489,2352756,2486245,06,California
2020-06-09,CO,28183,193704,221887,08,Colorado
2020-06-09,CT,44179,273843,318022,09,Connecticut
2020-06-09,DC,9474,47678,57152,11,District of Columbia
2020-06-09,DE,10020,60733,70753,10,Delaware
2020-06-09,FL,66000,1192305,1258305,12,Florida
2020-06-09,GA,53249,503934,557183,13,Georgia
2020-06-09,GU,180,7796,7976,66,Guam
2020-06-09,HI,676,54798,55474,15,Hawaii
2020-06-09,IA,22236,175487,197723,19,Iowa
2020-06-09,ID,3189,54488,57677,16,Idaho
2020-06-09,IL,129936,949970,1079906,17,Illinois
2020-06-09,IN,38033,277357,315390,18,Indiana
2020-06-09,KS,10650,108859,119509,20,Kansas
2020-06-09,KY,11708,248230,259938,21,Kentucky
2020-06-09,LA,43612,410056,453668,22,Louisiana
2020-06-09,MA,103889,558103,661992,25,Massachusetts
2020-06-09,MD,58904,319178,378082,24,Maryland
2020-06-09,ME,2606,59814,62420,23,Maine
2020-06-09,MI,65167,690869,756036,26,Michigan
2020-06-09,MN,29866,339927,369793,27,Minnesota
2020-06-09,MO,14913,230782,245695,29,Missouri
2020-06-09,MP,30,7493,7523,69,Northern Mariana Islands
2020-06-09,MS,17768,190444,208212,28,Mississippi
2020-06-09,MT,554,52630,53184,30,Montana
2020-06-09,NC,37160,498551,535711,37,North Carolina
2020-06-09,ND,2901,77765,80666,38,North Dakota
2020-06-09,NE,15752,106940,122692,31,Nebraska
2020-06-09,NH,5079,82044,87123,33,New Hampshire
2020-06-09,NJ,164796,824701,989497,34,New Jersey
2020-06-09,NM,9062,229739,238801,35,New Mexico
2020-06-09,NV,10030,173559,183589,32,Nevada
2020-06-09,NY,379482,2226387,2605869,36,New York
2020-06-09,OH,39162,451228,490390,39,Ohio
2020-06-09,OK,7363,226678,234041,40,Oklahoma
2020-06-09,OR,4988,148629,153617,41,Oregon
2020-06-09,PA,77056,459248,536304,42,Pennsylvania
2020-06-09,PR,5185,88685,93870,72,Puerto Rico
2020-06-09,RI,15751,110588,126339,44,Rhode Island
2020-06-09,SC,15228,232754,247982,45,South Carolina
2020-06-09,SD,5523,53636,59159,46,South Dakota
2020-06-09,TN,27575,493622,521197,47,Tennessee
2020-06-09,TX,77253,1070102,1147355,48,Texas
2020-06-09,UT,12559,234301,246860,49,Utah
2020-06-09,VA,51738,339118,390856,51,Virginia
2020-06-09,VI,71,2137,2208,78,U.S. Virgin Islands
2020-06-09,VT,1084,43144,44228,50,Vermont
2020-06-09,WA,26004,365086,391090,53,Washington
2020-06-09,WI,23734,347210,370944,55,Wisconsin
2020-06-09,WV,2169,112169,114338,54,West Virginia
2020-06-09,WY,970,29366,30336,56,Wyoming
2020-06-08,AK,563,65349,65912,02,Alaska
2020-06-08,AL,20925,239066,259991,01,Alabama
2020-06-08,AR,9740,150847,160587,05,Arkansas
2020-06-08,AS,0,174,174,60,American Samoa
2020-06-08,AZ,27678,260403,288081,04,Arizona
2020-06-08,CA,131319,2299871,2431190,06,California
2020-06-08,CO,28001,189483,217484,08,Colorado
2020-06-08,CT,44092,269603,313695,09,Connecticut
2020-06-08,DC,9389,46377,55766,11,District of Columbia
2020-06-08,DE,9972,59975,69947,10,Delaware
2020-06-08,FL,64904,1169646,1234550,12,Florida
2020-06-08,GA,52497,496878,549375,13,Georgia
2020-06-08,GU,179,7550,7729,66,Guam
2020-06-08,HI,675,54472,55147,15,Hawaii
2020-06-08,IA,21987,171635,193622,19,Iowa
2020-06-08,ID,3139,52902,56041,16,Idaho
2020-06-08,IL,129139,930458,1059597,17,Illinois
2020-06-08,IN,37623,271880,309503,18,Indiana
2020-06-08,KS,10650,108859,119509,20,Kansas
2020-06-08,KY,11476,241381,252857,21,Kentucky
2020-06-08,LA,43050,399552,442602,22,Louisiana
2020-06-08,MA,103626,553643,657269,25,Massachusetts
2020-06-08,MD,58404,313099,371503,24,Maryland
2020-06-08,ME,2588,59057,61645,23,Maine
2020-06-08,MI,65104,674060,739164,26,Michigan
2020-06-08,MN,29436,331476,360912,27,Minnesota
2020-06-08,MO,14734,226727,241461,29,Missouri
2020-06-08,MP,28,7214,7242,69,Northern Mariana Islands
2020-06-08,MS,17768,190444,208212,28,Mississippi
2020-06-08,MT,548,51044,51592,30,Montana
2020-06-08,NC,36484,483629,520113,37,North Carolina
2020-06-08,ND,2880,77300,80180,38,North Dakota
2020-06-08,NE,15634,105773,121407,31,Nebraska
2020-06-08,NH,5043,80509,85552,33,New Hampshire
2020-06-08,NJ,164497,810592,975089,34,New Jersey
2020-06-08,NM,8940,225435,234375,35,New Mexico
2020-06-08,NV,9786,170217,180003,32,Nevada
2020-06-08,NY,378799,2177097,2555896,36,New York
2020-06-08,OH,38837,437981,476818,39,Ohio
2020-06-08,OK,7205,214598,221803,40,Oklahoma
2020-06-08,OR,4922,144957,149879,41,Oregon
2020-06-08,PA,76563,451387,527950,42,Pennsylvania
2020-06-08,PR,5046,88685,93731,72,Puerto Rico
2020-06-08,RI,15683,109424,125107,44,Rhode Island
2020-06-08,SC,14800,229861,244661,45,South Carolina
2020-06-08,SD,5471,52348,57819,46,South Dakota
2020-06-08,TN,26944,485819,512763,47,Tennessee
2020-06-08,TX,75616,1044700,1120316,48,Texas
2020-06-08,UT,12322,230577,242899,49,Utah
2020-06-08,VA,51251,332341,383592,51,Virginia
2020-06-08,VI,71,2128,2199,78,U.S. Virgin Islands
2020-06-08,VT,1075,41723,42798,50,Vermont
2020-06-08,WA,25732,355573,381305,53,Washington
2020-06-08,WI,23434,333253,356687,55,Wisconsin
2020-06-08,WV,2153,111452,113605,54,West Virginia
2020-06-08,WY,960,29014,29974,56,Wyoming
2020-06-07,AK,544,64360,64904,02,Alaska
2020-06-07,AL,20500,239066,259566,01,Alabama
2020-06-07,AR,9426,150847,160273,05,Arkansas
2020-06-07,AS,0,174,174,60,American Samoa
2020-06-07,AZ,26889,254732,281621,04,Arizona
2020-06-07,CA,128812,2233406,2362218,06,California
2020-06-07,CO,27848,185166,213014,08,Colorado
2020-06-07,CT,43968,265055,309023,09,Connecticut
2020-06-07,DC,9332,45215,54547,11,District of Columbia
2020-06-07,DE,9942,59055,68997,10,Delaware
2020-06-07,FL,63938,1152220,1216158,12,Florida
2020-06-07,GA,51898,487986,539884,13,Georgia
2020-06-07,GU,179,7284,7463,66,Guam
2020-06-07,HI,673,53382,54055,15,Hawaii
2020-06-07,IA,21667,166525,188192,19,Iowa
2020-06-07,ID,3139,52902,56041,16,Idaho
2020-06-07,IL,127757,915017,1042774,17,Illinois
2020-06-07,IN,37397,266866,304263,18,Indiana
2020-06-07,KS,10393,103260,113653,20,Kansas
2020-06-07,KY,11287,237775,249062,21,Kentucky
2020-06-07,LA,42816,391249,434065,22,Louisiana
2020-06-07,MA,103436,549054,652490,25,Massachusetts
2020-06-07,MD,57973,306830,364803,24,Maryland
2020-06-07,ME,2570,56399,58969,23,Maine
2020-06-07,MI,64969,661256,726225,26,Michigan
2020-06-07,MN,28988,324153,353141,27,Minnesota
2020-06-07,MO,14553,222305,236858,29,Missouri
2020-06-07,MP,27,7214,7241,69,Northern Mariana Islands
2020-06-07,MS,17270,185979,203249,28,Mississippi
2020-06-07,MT,545,46833,47378,30,Montana
2020-06-07,NC,35546,475680,511226,37,North Carolina
2020-06-07,ND,2861,77072,79933,38,North Dakota
2020-06-07,NE,15543,104226,119769,31,Nebraska
2020-06-07,NH,5019,78990,84009,33,New Hampshire
2020-06-07,NJ,164164,796261,960425,34,New Jersey
2020-06-07,NM,8800,220347,229147,35,New Mexico
2020-06-07,NV,9649,166048,175697,32,Nevada
2020-06-07,NY,378097,2119745,2497842,36,New York
2020-06-07,OH,38476,430548,469024,39,Ohio
2020-06-07,OK,7150,214598,221748,40,Oklahoma
2020-06-07,OR,4808,143592,148400,41,Oregon
2020-06-07,PA,76212,444173,520385,42,Pennsylvania
2020-06-07,PR,4985,88685,93670,72,Puerto Rico
2020-06-07,RI,15638,108540,124178,44,Rhode Island
2020-06-07,SC,14286,223573,237859,45,South Carolina
2020-06-07,SD,5438,51622,57060,46,South Dakota
2020-06-07,TN,26381,472387,498768,47,Tennessee
2020-06-07,TX,74978,1025468,1100446,48,Texas
2020-06-07,UT,12066,225885,237951,49,Utah
2020-06-07,VA,50681,329135,379816,51,Virginia
2020-06-07,VI,71,2125,2196,78,U.S. Virgin Islands
2020-06-07,VT,1063,40155,41218,50,Vermont
2020-06-07,WA,25419,347610,373029,53,Washington
2020-06-07,WI,23212,325867,349079,55,Wisconsin
2020-06-07,WV,2144,109663,111807,54,West Virginia
2020-06-07,WY,947,27804,28751,56,Wyoming
2020-06-06,AK,536,63365,63901,02,Alaska
2020-06-06,AL,20043,225601,245644,01,Alabama
2020-06-06,AR,9101,147656,156757,05,Arkansas
2020-06-06,AS,0,174,174,60,American Samoa
2020-06-06,AZ,25451,246195,271646,04,Arizona
2020-06-06,CA,126016,2182284,2308300,06,California
2020-06-06,CO,27615,180662,208277,08,Colorado
2020-06-06,CT,43818,259611,303429,09,Connecticut
2020-06-06,DC,9269,44409,53678,11,District of Columbia
2020-06-06,DE,9845,57790,67635,10,Delaware
2020-06-06,FL,62758,1111427,1174185,12,Florida
2020-06-06,GA,51309,471548,522857,13,Georgia
2020-06-06,GU,179,7284,7463,66,Guam
2020-06-06,HI,664,52593,53257,15,Hawaii
2020-06-06,IA,21478,163236,184714,19,Iowa
2020-06-06,ID,3111,52128,55239,16,Idaho
2020-06-06,IL,126890,895184,1022074,17,Illinois
2020-06-06,IN,36997,260533,297530,18,Indiana
2020-06-06,KS,10393,103260,113653,20,Kansas
2020-06-06,KY,11287,237775,249062,21,Kentucky
2020-06-06,LA,42486,385583,428069,22,Louisiana
2020-06-06,MA,103132,541507,644639,25,Massachusetts
2020-06-06,MD,57482,299894,357376,24,Maryland
2020-06-06,ME,2524,56399,58923,23,Maine
2020-06-06,MI,64914,650942,715856,26,Michigan
2020-06-06,MN,28853,314744,343597,27,Minnesota
2020-06-06,MO,14442,215623,230065,29,Missouri
2020-06-06,MP,26,6669,6695,69,Northern Mariana Islands
2020-06-06,MS,16769,176354,193123,28,Mississippi
2020-06-06,MT,540,46214,46754,30,Montana
2020-06-06,NC,34625,462725,497350,37,North Carolina
2020-06-06,ND,2816,76064,78880,38,North Dakota
2020-06-06,NE,15379,102168,117547,31,Nebraska
2020-06-06,NH,5019,78990,84009,33,New Hampshire
2020-06-06,NJ,163893,755555,919448,34,New Jersey
2020-06-06,NM,8672,215968,224640,35,New Mexico
2020-06-06,NV,9460,162311,171771,32,Nevada
2020-06-06,NY,377316,2060091,2437407,36,New York
2020-06-06,OH,38111,420415,458526,39,Ohio
2020-06-06,OK,7003,214598,221601,40,Oklahoma
2020-06-06,OR,4662,141497,146159,41,Oregon
2020-06-06,PA,75706,435122,510828,42,Pennsylvania
2020-06-06,PR,4915,88685,93600,72,Puerto Rico
2020-06-06,RI,15589,107782,123371,44,Rhode Island
2020-06-06,SC,13916,218828,232744,45,South Carolina
2020-06-06,SD,5367,50091,55458,46,South Dakota
2020-06-06,TN,26071,465350,491421,47,Tennessee
2020-06-06,TX,73553,1019724,1093277,48,Texas
2020-06-06,UT,11798,223351,235149,49,Utah
2020-06-06,VA,49397,321734,371131,51,Virginia
2020-06-06,VI,71,2125,2196,78,U.S. Virgin Islands
2020-06-06,VT,1046,39037,40083,50,Vermont
2020-06-06,WA,25227,345430,370657,53,Washington
2020-06-06,WI,22937,314802,337739,55,Wisconsin
2020-06-06,WV,2131,107592,109723,54,West Virginia
2020-06-06,WY,939,27569,28508,56,Wyoming
2020-06-05,AK,524,60466,60990,02,Alaska
2020-06-05,AL,19387,220086,239473,01,Alabama
2020-06-05,AR,8651,138960,147611,05,Arkansas
2020-06-05,AS,0,174,174,60,American Samoa
2020-06-05,AZ,24332,239533,263865,04,Arizona
2020-06-05,CA,122901,2115562,2238463,06,California
2020-06-05,CO,27360,176064,203424,08,Colorado
2020-06-05,CT,43460,243927,287387,09,Connecticut
2020-06-05,DC,9199,42662,51861,11,District of Columbia
2020-06-05,DE,9773,56956,66729,10,Delaware
2020-06-05,FL,61488,1073452,1134940,12,Florida
2020-06-05,GA,50621,457167,507788,13,Georgia
2020-06-05,GU,179,7195,7374,66,Guam
2020-06-05,HI,655,51681,52336,15,Hawaii
2020-06-05,IA,21152,159511,180663,19,Iowa
2020-06-05,ID,3054,50570,53624,16,Idaho
2020-06-05,IL,125915,875004,1000919,17,Illinois
2020-06-05,IN,36578,255060,291638,18,Indiana
2020-06-05,KS,10393,103260,113653,20,Kansas
2020-06-05,KY,10977,231440,242417,21,Kentucky
2020-06-05,LA,41989,378797,420786,22,Louisiana
2020-06-05,MA,102557,532212,634769,25,Massachusetts
2020-06-05,MD,56770,290956,347726,24,Maryland
2020-06-05,ME,2482,55050,57532,23,Maine
2020-06-05,MI,64821,640450,705271,26,Michigan
2020-06-05,MN,28688,304497,333185,27,Minnesota
2020-06-05,MO,14253,210289,224542,29,Missouri
2020-06-05,MP,26,6669,6695,69,Northern Mariana Islands
2020-06-05,MS,16759,176354,193113,28,Mississippi
2020-06-05,MT,541,45347,45888,30,Montana
2020-06-05,NC,33255,448892,482147,37,North Carolina
2020-06-05,ND,2745,74111,76856,38,North Dakota
2020-06-05,NE,15117,99705,114822,31,Nebraska
2020-06-05,NH,4876,74889,79765,33,New Hampshire
2020-06-05,NJ,163336,755555,918891,34,New Jersey
2020-06-05,NM,8353,209404,217757,35,New Mexico
2020-06-05,NV,9266,156841,166107,32,Nevada
2020-06-05,NY,376208,1983304,2359512,36,New York
2020-06-05,OH,37758,408437,446195,39,Ohio
2020-06-05,OK,6907,209564,216471,40,Oklahoma
2020-06-05,OR,4570,138676,143246,41,Oregon
2020-06-05,PA,75005,424201,499206,42,Pennsylvania
2020-06-05,PR,4620,60422,65042,72,Puerto Rico
2020-06-05,RI,15521,106656,122177,44,Rhode Island
2020-06-05,SC,13453,217846,231299,45,South Carolina
2020-06-05,SD,5277,48086,53363,46,South Dakota
2020-06-05,TN,25520,456652,482172,47,Tennessee
2020-06-05,TX,71613,989963,1061576,48,Texas
2020-06-05,UT,11252,220945,232197,49,Utah
2020-06-05,VA,48532,315238,363770,51,Virginia
2020-06-05,VI,71,1980,2051,78,U.S. Virgin Islands
2020-06-05,VT,1027,38090,39117,50,Vermont
2020-06-05,WA,25023,341885,366908,53,Washington
2020-06-05,WI,22599,303332,325931,55,Wisconsin
2020-06-05,WV,2119,106399,108518,54,West Virginia
2020-06-05,WY,933,26679,27612,56,Wyoming
2020-06-04,AK,513,59584,60097,02,Alaska
2020-06-04,AL,19072,216227,235299,01,Alabama
2020-06-04,AR,8067,134413,142480,05,Arkansas
2020-06-04,AS,0,174,174,60,American Samoa
2020-06-04,AZ,22753,227002,249755,04,Arizona
2020-06-04,CA,119807,2062864,2182671,06,California
2020-06-04,CO,27060,170140,197200,08,Colorado
2020-06-04,CT,43239,238286,281525,09,Connecticut
2020-06-04,DC,9120,41976,51096,11,District of Columbia
2020-06-04,DE,9746,56163,65909,10,Delaware
2020-06-04,FL,60183,1046860,1107043,12,Florida
2020-06-04,GA,49847,446484,496331,13,Georgia
2020-06-04,GU,179,6805,6984,66,Guam
2020-06-04,HI,653,49985,50638,15,Hawaii
2020-06-04,IA,20805,154130,174935,19,Iowa
2020-06-04,ID,2990,46815,49805,16,Idaho
2020-06-04,IL,124759,857257,982016,17,Illinois
2020-06-04,IN,36096,249138,285234,18,Indiana
2020-06-04,KS,10170,97883,108053,20,Kansas
2020-06-04,KY,10705,225220,235925,21,Kentucky
2020-06-04,LA,41562,369624,411186,22,Louisiana
2020-06-04,MA,102063,522872,624935,25,Massachusetts
2020-06-04,MD,55858,281160,337018,24,Maryland
2020-06-04,ME,2446,53755,56201,23,Maine
2020-06-04,MI,64616,627907,692523,26,Michigan
2020-06-04,MN,28290,293858,322148,27,Minnesota
2020-06-04,MO,14057,204604,218661,29,Missouri
2020-06-04,MP,26,6669,6695,69,Northern Mariana Islands
2020-06-04,MS,16560,168425,184985,28,Mississippi
2020-06-04,MT,539,44103,44642,30,Montana
2020-06-04,NC,31966,436336,468302,37,North Carolina
2020-06-04,ND,2706,73038,75744,38,North Dakota
2020-06-04,NE,14866,97389,112255,31,Nebraska
2020-06-04,NH,4795,71170,75965,33,New Hampshire
2020-06-04,NJ,162530,695199,857729,34,New Jersey
2020-06-04,NM,8140,204856,212996,35,New Mexico
2020-06-04,NV,9090,152333,161423,32,Nevada
2020-06-04,NY,375133,1917899,2293032,36,New York
2020-06-04,OH,37282,399969,437251,39,Ohio
2020-06-04,OK,6907,204815,211722,40,Oklahoma
2020-06-04,OR,4474,134838,139312,41,Oregon
2020-06-04,PA,74560,416942,491502,42,Pennsylvania
2020-06-04,PR,4508,60422,64930,72,Puerto Rico
2020-06-04,RI,15416,105136,120552,44,Rhode Island
2020-06-04,SC,13005,217846,230851,45,South Carolina
2020-06-04,SD,5247,47375,52622,46,South Dakota
2020-06-04,TN,25120,451018,476138,47,Tennessee
2020-06-04,TX,69920,968635,1038555,48,Texas
2020-06-04,UT,10813,216694,227507,49,Utah
2020-06-04,VA,47856,305734,353590,51,Virginia
2020-06-04,VI,71,1975,2046,78,U.S. Virgin Islands
2020-06-04,VT,1026,36808,37834,50,Vermont
2020-06-04,WA,24677,335972,360649,53,Washington
2020-06-04,WI,22193,291367,313560,55,Wisconsin
2020-06-04,WV,2092,103957,106049,54,West Virginia
2020-06-04,WY,915,26074,26989,56,Wyoming
2020-06-03,AK,505,57677,58182,02,Alaska
2020-06-03,AL,18851,212743,231594,01,Alabama
2020-06-03,AR,8067,134413,142480,05,Arkansas
2020-06-03,AS,0,174,174,60,American Samoa
2020-06-03,AZ,22233,222292,244525,04,Arizona
2020-06-03,CA,117687,2013607,2131294,06,California
2020-06-03,CO,26788,167389,194177,08,Colorado
2020-06-03,CT,43091,233345,276436,09,Connecticut
2020-06-03,DC,9016,40546,49562,11,District of Columbia
2020-06-03,DE,9712,55208,64920,10,Delaware
2020-06-03,FL,58764,1022149,1080913,12,Florida
2020-06-03,GA,48894,433818,482712,13,Georgia
2020-06-03,GU,178,6549,6727,66,Guam
2020-06-03,HI,653,48855,49508,15,Hawaii
2020-06-03,IA,20055,144390,164445,19,Iowa
2020-06-03,ID,2933,46009,48942,16,Idaho
2020-06-03,IL,123830,835345,959175,17,Illinois
2020-06-03,IN,35712,242103,277815,18,Indiana
2020-06-03,KS,10170,97883,108053,20,Kansas
2020-06-03,KY,10410,221789,232199,21,Kentucky
2020-06-03,LA,41133,360954,402087,22,Louisiana
2020-06-03,MA,101592,516169,617761,25,Massachusetts
2020-06-03,MD,54982,272643,327625,24,Maryland
2020-06-03,ME,2418,50591,53009,23,Maine
2020-06-03,MI,64382,613173,677555,26,Michigan
2020-06-03,MN,27889,283319,311208,27,Minnesota
2020-06-03,MO,13767,197586,211353,29,Missouri
2020-06-03,MP,23,6534,6557,69,Northern Mariana Islands
2020-06-03,MS,16322,168425,184747,28,Mississippi
2020-06-03,MT,525,42923,43448,30,Montana
2020-06-03,NC,30777,418486,449263,37,North Carolina
2020-06-03,ND,2679,71823,74502,38,North Dakota
2020-06-03,NE,14611,95355,109966,31,Nebraska
2020-06-03,NH,4749,70990,75739,33,New Hampshire
2020-06-03,NJ,162068,675352,837420,34,New Jersey
2020-06-03,NM,8024,198813,206837,35,New Mexico
2020-06-03,NV,8935,147320,156255,32,Nevada
2020-06-03,NY,374085,1855388,2229473,36,New York
2020-06-03,OH,36792,389313,426105,39,Ohio
2020-06-03,OK,6805,201247,208052,40,Oklahoma
2020-06-03,OR,4399,132269,136668,41,Oregon
2020-06-03,PA,74022,401369,475391,42,Pennsylvania
2020-06-03,PR,4023,60422,64445,72,Puerto Rico
2020-06-03,RI,15299,103136,118435,44,Rhode Island
2020-06-03,SC,12651,210274,222925,45,South Carolina
2020-06-03,SD,5162,43500,48662,46,South Dakota
2020-06-03,TN,24822,445957,470779,47,Tennessee
2020-06-03,TX,68271,938497,1006768,48,Texas
2020-06-03,UT,10497,213484,223981,49,Utah
2020-06-03,VA,46905,295482,342387,51,Virginia
2020-06-03,VI,70,1956,2026,78,U.S. Virgin Islands
2020-06-03,VT,990,36205,37195,50,Vermont
2020-06-03,WA,24385,331675,356060,53,Washington
2020-06-03,WI,21661,279711,301372,55,Wisconsin
2020-06-03,WV,2071,101697,103768,54,West Virginia
2020-06-03,WY,915,25713,26628,56,Wyoming
2020-06-02,AK,487,55716,56203,02,Alaska
2020-06-02,AL,18642,205160,223802,01,Alabama
2020-06-02,AR,7443,125793,133236,05,Arkansas
2020-06-02,AS,0,174,174,60,American Samoa
2020-06-02,AZ,21250,216583,237833,04,Arizona
2020-06-02,CA,115310,1956281,2071591,06,California
2020-06-02,CO,26577,163960,190537,08,Colorado
2020-06-02,CT,42979,227631,270610,09,Connecticut
2020-06-02,DC,8886,38815,47701,11,District of Columbia
2020-06-02,DE,9685,54377,64062,10,Delaware
2020-06-02,FL,57447,992305,1049752,12,Florida
2020-06-02,GA,48207,426080,474287,13,Georgia
2020-06-02,GU,177,6214,6391,66,Guam
2020-06-02,HI,652,48269,48921,15,Hawaii
2020-06-02,IA,20016,143674,163690,19,Iowa
2020-06-02,ID,2906,45227,48133,16,Idaho
2020-06-02,IL,122848,811856,934704,17,Illinois
2020-06-02,IN,35237,236682,271919,18,Indiana
2020-06-02,KS,10011,93301,103312,20,Kansas
2020-06-02,KY,10185,217086,227271,21,Kentucky
2020-06-02,LA,40746,352387,393133,22,Louisiana
2020-06-02,MA,101163,508232,609395,25,Massachusetts
2020-06-02,MD,54175,261640,315815,24,Maryland
2020-06-02,ME,2377,50591,52968,23,Maine
2020-06-02,MI,64103,597072,661175,26,Michigan
2020-06-02,MN,27376,267931,295307,27,Minnesota
2020-06-02,MO,13575,191855,205430,29,Missouri
2020-06-02,MP,23,6534,6557,69,Northern Mariana Islands
2020-06-02,MS,16020,163478,179498,28,Mississippi
2020-06-02,MT,523,41689,42212,30,Montana
2020-06-02,NC,29889,405032,434921,37,North Carolina
2020-06-02,ND,2646,70998,73644,38,North Dakota
2020-06-02,NE,14345,92073,106418,31,Nebraska
2020-06-02,NH,4685,69659,74344,33,New Hampshire
2020-06-02,NJ,161545,656132,817677,34,New Jersey
2020-06-02,NM,7800,195315,203115,35,New Mexico
2020-06-02,NV,8830,143261,152091,32,Nevada
2020-06-02,NY,373040,1794791,2167831,36,New York
2020-06-02,OH,36350,373558,409908,39,Ohio
2020-06-02,OK,6692,197965,204657,40,Oklahoma
2020-06-02,OR,4335,129874,134209,41,Oregon
2020-06-02,PA,73510,399361,472871,42,Pennsylvania
2020-06-02,PR,3935,60422,64357,72,Puerto Rico
2020-06-02,RI,15194,101512,116706,44,Rhode Island
2020-06-02,SC,12415,206362,218777,45,South Carolina
2020-06-02,SD,5067,41779,46846,46,South Dakota
2020-06-02,TN,24375,437761,462136,47,Tennessee
2020-06-02,TX,66568,919656,986224,48,Texas
2020-06-02,UT,10202,211589,221791,49,Utah
2020-06-02,VA,46239,282650,328889,51,Virginia
2020-06-02,VI,70,1936,2006,78,U.S. Virgin Islands
2020-06-02,VT,988,35631,36619,50,Vermont
2020-06-02,WA,24086,326646,350732,53,Washington
2020-06-02,WI,21155,263743,284898,55,Wisconsin
2020-06-02,WV,2041,98502,100543,54,West Virginia
2020-06-02,WY,910,24832,25742,56,Wyoming
2020-06-01,AK,467,53723,54190,02,Alaska
2020-06-01,AL,18363,205160,223523,01,Alabama
2020-06-01,AR,7443,125793,133236,05,Arkansas
2020-06-01,AS,0,174,174,60,American Samoa
2020-06-01,AZ,20123,207947,228070,04,Arizona
2020-06-01,CA,113006,1899577,2012583,06,California
2020-06-01,CO,26378,159998,186376,08,Colorado
2020-06-01,CT,42740,218650,261390,09,Connecticut
2020-06-01,DC,8857,38406,47263,11,District of Columbia
2020-06-01,DE,9605,52842,62447,10,Delaware
2020-06-01,FL,56830,983570,1040400,12,Florida
2020-06-01,GA,47618,424013,471631,13,Georgia
2020-06-01,GU,175,6141,6316,66,Guam
2020-06-01,HI,652,47835,48487,15,Hawaii
2020-06-01,IA,19697,139384,159081,19,Iowa
2020-06-01,ID,2839,43858,46697,16,Idaho
2020-06-01,IL,121234,797039,918273,17,Illinois
2020-06-01,IN,34830,231066,265896,18,Indiana
2020-06-01,KS,10011,85230,95241,20,Kansas
2020-06-01,KY,10046,206000,216046,21,Kentucky
2020-06-01,LA,40341,347029,387370,22,Louisiana
2020-06-01,MA,100805,502628,603433,25,Massachusetts
2020-06-01,MD,53327,255403,308730,24,Maryland
2020-06-01,ME,2349,47284,49633,23,Maine
2020-06-01,MI,63813,581424,645237,26,Michigan
2020-06-01,MN,26897,260739,287636,27,Minnesota
2020-06-01,MO,13327,186381,199708,29,Missouri
2020-06-01,MP,22,6312,6334,69,Northern Mariana Islands
2020-06-01,MS,15752,160502,176254,28,Mississippi
2020-06-01,MT,519,40138,40657,30,Montana
2020-06-01,NC,29263,392645,421908,37,North Carolina
2020-06-01,ND,2625,70676,73301,38,North Dakota
2020-06-01,NE,14101,89564,103665,31,Nebraska
2020-06-01,NH,4651,67805,72456,33,New Hampshire
2020-06-01,NJ,160918,634682,795600,34,New Jersey
2020-06-01,NM,7689,191915,199604,35,New Mexico
2020-06-01,NV,8688,138095,146783,32,Nevada
2020-06-01,NY,371711,1742066,2113777,36,New York
2020-06-01,OH,35984,362082,398066,39,Ohio
2020-06-01,OK,6573,186700,193273,40,Oklahoma
2020-06-01,OR,4302,127316,131618,41,Oregon
2020-06-01,PA,72898,389431,462329,42,Pennsylvania
2020-06-01,PR,3873,60422,64295,72,Puerto Rico
2020-06-01,RI,15087,100112,115199,44,Rhode Island
2020-06-01,SC,12148,192540,204688,45,South Carolina
2020-06-01,SD,5034,40627,45661,46,South Dakota
2020-06-01,TN,23554,424939,448493,47,Tennessee
2020-06-01,TX,64880,905151,970031,48,Texas
2020-06-01,UT,9999,208113,218112,49,Utah
2020-06-01,VA,45398,279321,324719,51,Virginia
2020-06-01,VI,70,1741,1811,78,U.S. Virgin Islands
2020-06-01,VT,983,34343,35326,50,Vermont
2020-06-01,WA,23798,320527,344325,53,Washington
2020-06-01,WI,20736,253595,274331,55,Wisconsin
2020-06-01,WV,2017,96078,98095,54,West Virginia
2020-06-01,WY,910,24237,25147,56,Wyoming
2020-05-31,AK,434,51261,51695,02,Alaska
2020-05-31,AL,17903,199650,217553,01,Alabama
2020-05-31,AR,7253,122262,129515,05,Arkansas
2020-05-31,AS,0,174,174,60,American Samoa
2020-05-31,AZ,19936,205270,225206,04,Arizona
2020-05-31,CA,110583,1834265,1944848,06,California
2020-05-31,CO,26098,154529,180627,08,Colorado
2020-05-31,CT,42201,207845,250046,09,Connecticut
2020-05-31,DC,8801,37682,46483,11,District of Columbia
2020-05-31,DE,9498,51173,60671,10,Delaware
2020-05-31,FL,56163,965186,1021349,12,Florida
2020-05-31,GA,46986,418539,465525,13,Georgia
2020-05-31,GU,173,5929,6102,66,Guam
2020-05-31,HI,651,53969,54620,15,Hawaii
2020-05-31,IA,19552,136744,156296,19,Iowa
2020-05-31,ID,2839,43858,46697,16,Idaho
2020-05-31,IL,120260,777999,898259,17,Illinois
2020-05-31,IN,34574,226972,261546,18,Indiana
2020-05-31,KS,9719,85230,94949,20,Kansas
2020-05-31,KY,9704,204049,213753,21,Kentucky
2020-05-31,LA,39916,335193,375109,22,Louisiana
2020-05-31,MA,96965,495888,592853,25,Massachusetts
2020-05-31,MD,52778,249103,301881,24,Maryland
2020-05-31,ME,2325,47284,49609,23,Maine
2020-05-31,MI,63568,567192,630760,26,Michigan
2020-05-31,MN,26322,257133,283455,27,Minnesota
2020-05-31,MO,13147,180414,193561,29,Missouri
2020-05-31,MP,22,6151,6173,69,Northern Mariana Islands
2020-05-31,MS,15501,156336,171837,28,Mississippi
2020-05-31,MT,515,39283,39798,30,Montana
2020-05-31,NC,28589,387700,416289,37,North Carolina
2020-05-31,ND,2577,69463,72040,38,North Dakota
2020-05-31,NE,13905,87237,101142,31,Nebraska
2020-05-31,NH,4545,65735,70280,33,New Hampshire
2020-05-31,NJ,160445,585700,746145,34,New Jersey
2020-05-31,NM,7624,186823,194447,35,New Mexico
2020-05-31,NV,8593,133967,142560,32,Nevada
2020-05-31,NY,370770,1693055,2063825,36,New York
2020-05-31,OH,35513,355395,390908,39,Ohio
2020-05-31,OK,6506,186700,193206,40,Oklahoma
2020-05-31,OR,4243,124958,129201,41,Oregon
2020-05-31,PA,72546,383111,455657,42,Pennsylvania
2020-05-31,PR,3776,60422,64198,72,Puerto Rico
2020-05-31,RI,14988,98790,113778,44,Rhode Island
2020-05-31,SC,11861,188355,200216,45,South Carolina
2020-05-31,SD,4993,39135,44128,46,South Dakota
2020-05-31,TN,23006,412971,435977,47,Tennessee
2020-05-31,TX,64287,887578,951865,48,Texas
2020-05-31,UT,9797,204117,213914,49,Utah
2020-05-31,VA,44607,270784,315391,51,Virginia
2020-05-31,VI,69,1633,1702,78,U.S. Virgin Islands
2020-05-31,VT,981,32989,33970,50,Vermont
2020-05-31,WA,23456,314671,338127,53,Washington
2020-05-31,WI,20564,250103,270667,55,Wisconsin
2020-05-31,WV,2010,95612,97622,54,West Virginia
2020-05-31,WY,903,23490,24393,56,Wyoming
2020-05-30,AK,434,51261,51695,02,Alaska
2020-05-30,AL,17359,194842,212201,01,Alabama
2020-05-30,AR,7013,119484,126497,05,Arkansas
2020-05-30,AS,0,174,174,60,American Samoa
2020-05-30,AZ,19255,197792,217047,04,Arizona
2020-05-30,CA,106878,1781717,1888595,06,California
2020-05-30,CO,25613,150128,175741,08,Colorado
2020-05-30,CT,42022,204913,246935,09,Connecticut
2020-05-30,DC,8717,36912,45629,11,District of Columbia
2020-05-30,DE,9422,49907,59329,10,Delaware
2020-05-30,FL,55424,939544,994968,12,Florida
2020-05-30,GA,46286,408552,454838,13,Georgia
2020-05-30,GU,173,5929,6102,66,Guam
2020-05-30,HI,649,53365,54014,15,Hawaii
2020-05-30,IA,19244,131179,150423,19,Iowa
2020-05-30,ID,2803,42621,45424,16,Idaho
2020-05-30,IL,118917,758188,877105,17,Illinois
2020-05-30,IN,34211,222184,256395,18,Indiana
2020-05-30,KS,9719,85230,94949,20,Kansas
2020-05-30,KY,9464,198731,208195,21,Kentucky
2020-05-30,LA,39577,329242,368819,22,Louisiana
2020-05-30,MA,96301,486218,582519,25,Massachusetts
2020-05-30,MD,52015,241931,293946,24,Maryland
2020-05-30,ME,2282,47284,49566,23,Maine
2020-05-30,MI,63321,554509,617830,26,Michigan
2020-05-30,MN,26181,250392,276573,27,Minnesota
2020-05-30,MO,12962,172468,185430,29,Missouri
2020-05-30,MP,22,5986,6008,69,Northern Mariana Islands
2020-05-30,MS,15229,150703,165932,28,Mississippi
2020-05-30,MT,505,38779,39284,30,Montana
2020-05-30,NC,27673,376484,404157,37,North Carolina
2020-05-30,ND,2554,68427,70981,38,North Dakota
2020-05-30,NE,13654,85354,99008,31,Nebraska
2020-05-30,NH,4492,64468,68960,33,New Hampshire
2020-05-30,NJ,159608,585700,745308,34,New Jersey
2020-05-30,NM,7493,180768,188261,35,New Mexico
2020-05-30,NV,8495,130037,138532,32,Nevada
2020-05-30,NY,369660,1635721,2005381,36,New York
2020-05-30,OH,35034,346913,381947,39,Ohio
2020-05-30,OK,6418,186700,193118,40,Oklahoma
2020-05-30,OR,4185,122610,126795,41,Oregon
2020-05-30,PA,72031,375741,447772,42,Pennsylvania
2020-05-30,PR,3718,60422,64140,72,Puerto Rico
2020-05-30,RI,14912,97940,112852,44,Rhode Island
2020-05-30,SC,11394,178125,189519,45,South Carolina
2020-05-30,SD,4960,37978,42938,46,South Dakota
2020-05-30,TN,22566,404480,427046,47,Tennessee
2020-05-30,TX,62338,866179,928517,48,Texas
2020-05-30,UT,9533,200572,210105,49,Utah
2020-05-30,VA,43611,261901,305512,51,Virginia
2020-05-30,VI,69,1633,1702,78,U.S. Virgin Islands
2020-05-30,VT,977,31690,32667,50,Vermont
2020-05-30,WA,23275,312508,335783,53,Washington
2020-05-30,WI,20382,242908,263290,55,Wisconsin
2020-05-30,WV,1974,93916,95890,54,West Virginia
2020-05-30,WY,898,23185,24083,56,Wyoming
2020-05-29,AK,430,49009,49439,02,Alaska
2020-05-29,AL,16823,192060,208883,01,Alabama
2020-05-29,AR,6538,113230,119768,05,Arkansas
2020-05-29,AS,0,174,174,60,American Samoa
2020-05-29,AZ,18465,191348,209813,04,Arizona
2020-05-29,CA,103886,1731592,1835478,06,California
2020-05-29,CO,25121,143838,168959,08,Colorado
2020-05-29,CT,41762,199631,241393,09,Connecticut
2020-05-29,DC,8538,35320,43858,11,District of Columbia
2020-05-29,DE,9236,48297,57533,10,Delaware
2020-05-29,FL,54497,928742,983239,12,Florida
2020-05-29,GA,45670,404601,450271,13,Georgia
2020-05-29,GU,172,5923,6095,66,Guam
2020-05-29,HI,647,52177,52824,15,Hawaii
2020-05-29,IA,18926,128394,147320,19,Iowa
2020-05-29,ID,2769,41992,44761,16,Idaho
2020-05-29,IL,117455,734307,851762,17,Illinois
2020-05-29,IN,33558,215155,248713,18,Indiana
2020-05-29,KS,9719,85230,94949,20,Kansas
2020-05-29,KY,9184,212090,221274,21,Kentucky
2020-05-29,LA,38802,316225,355027,22,Louisiana
2020-05-29,MA,95512,476233,571745,25,Massachusetts
2020-05-29,MD,50988,233530,284518,24,Maryland
2020-05-29,ME,2226,43480,45706,23,Maine
2020-05-29,MI,63116,538868,601984,26,Michigan
2020-05-29,MN,26013,242124,268137,27,Minnesota
2020-05-29,MO,12795,165055,177850,29,Missouri
2020-05-29,MP,22,5662,5684,69,Northern Mariana Islands
2020-05-29,MS,14790,151518,166308,28,Mississippi
2020-05-29,MT,493,38036,38529,30,Montana
2020-05-29,NC,26488,364743,391231,37,North Carolina
2020-05-29,ND,2520,66933,69453,38,North Dakota
2020-05-29,NE,13261,81542,94803,31,Nebraska
2020-05-29,NH,4386,62476,66862,33,New Hampshire
2020-05-29,NJ,158844,557567,716411,34,New Jersey
2020-05-29,NM,7364,176180,183544,35,New Mexico
2020-05-29,NV,8350,126066,134416,32,Nevada
2020-05-29,NY,368284,1575846,1944130,36,New York
2020-05-29,OH,34566,335324,369890,39,Ohio
2020-05-29,OK,6338,181060,187398,40,Oklahoma
2020-05-29,OR,4131,118550,122681,41,Oregon
2020-05-29,PA,71339,366970,438309,42,Pennsylvania
2020-05-29,PR,3647,60422,64069,72,Puerto Rico
2020-05-29,RI,14808,96112,110920,44,Rhode Island
2020-05-29,SC,11131,177126,188257,45,South Carolina
2020-05-29,SD,4866,35816,40682,46,South Dakota
2020-05-29,TN,22085,399882,421967,47,Tennessee
2020-05-29,TX,61006,832269,893275,48,Texas
2020-05-29,UT,9264,196591,205855,49,Utah
2020-05-29,VA,42533,255844,298377,51,Virginia
2020-05-29,VI,69,1633,1702,78,U.S. Virgin Islands
2020-05-29,VT,975,30910,31885,50,Vermont
2020-05-29,WA,23047,309438,332485,53,Washington
2020-05-29,WI,19843,233588,253431,55,Wisconsin
2020-05-29,WV,1951,91426,93377,54,West Virginia
2020-05-29,WY,891,22378,23269,56,Wyoming
2020-05-28,AK,425,47545,47970,02,Alaska
2020-05-28,AL,16310,184171,200481,01,Alabama
2020-05-28,AR,6538,112364,118902,05,Arkansas
2020-05-28,AS,0,174,174,60,American Samoa
2020-05-28,AZ,17763,185151,202914,04,Arizona
2020-05-28,CA,101697,1688862,1790559,06,California
2020-05-28,CO,24767,138356,163123,08,Colorado
2020-05-28,CT,41559,193966,235525,09,Connecticut
2020-05-28,DC,8492,35022,43514,11,District of Columbia
2020-05-28,DE,9171,47630,56801,10,Delaware
2020-05-28,FL,53285,898331,951616,12,Florida
2020-05-28,GA,45070,399576,444646,13,Georgia
2020-05-28,GU,172,5790,5962,66,Guam
2020-05-28,HI,644,51195,51839,15,Hawaii
2020-05-28,IA,18573,124360,142933,19,Iowa
2020-05-28,ID,2731,41144,43875,16,Idaho
2020-05-28,IL,115833,714133,829966,17,Illinois
2020-05-28,IN,33068,209219,242287,18,Indiana
2020-05-28,KS,9337,75151,84488,20,Kansas
2020-05-28,KY,9077,173024,182101,21,Kentucky
2020-05-28,LA,38802,316225,355027,22,Louisiana
2020-05-28,MA,94895,467428,562323,25,Massachusetts
2020-05-28,MD,49709,225149,274858,24,Maryland
2020-05-28,ME,2189,43480,45669,23,Maine
2020-05-28,MI,62797,522663,585460,26,Michigan
2020-05-28,MN,25559,232195,257754,27,Minnesota
2020-05-28,MO,12673,158394,171067,29,Missouri
2020-05-28,MP,22,5401,5423,69,Northern Mariana Islands
2020-05-28,MS,14372,142125,156497,28,Mississippi
2020-05-28,MT,485,36308,36793,30,Montana
2020-05-28,NC,25412,349780,375192,37,North Carolina
2020-05-28,ND,2481,65773,68254,38,North Dakota
2020-05-28,NE,12976,80004,92980,31,Nebraska
2020-05-28,NH,4286,61310,65596,33,New Hampshire
2020-05-28,NJ,157815,528042,685857,34,New Jersey
2020-05-28,NM,7252,172291,179543,35,New Mexico
2020-05-28,NV,8208,122982,131190,32,Nevada
2020-05-28,NY,366733,1510056,1876789,36,New York
2020-05-28,OH,33915,326097,360012,39,Ohio
2020-05-28,OK,6270,176136,182406,40,Oklahoma
2020-05-28,OR,4086,115561,119647,41,Oregon
2020-05-28,PA,70042,357804,427846,42,Pennsylvania
2020-05-28,PR,3486,60422,63908,72,Puerto Rico
2020-05-28,RI,14630,94575,109205,44,Rhode Island
2020-05-28,SC,10788,171461,182249,45,South Carolina
2020-05-28,SD,4793,34233,39026,46,South Dakota
2020-05-28,TN,21679,394310,415989,47,Tennessee
2020-05-28,TX,59776,813442,873218,48,Texas
2020-05-28,UT,8921,194586,203507,49,Utah
2020-05-28,VA,41401,245880,287281,51,Virginia
2020-05-28,VI,69,1617,1686,78,U.S. Virgin Islands
2020-05-28,VT,974,30178,31152,50,Vermont
2020-05-28,WA,22753,304340,327093,53,Washington
2020-05-28,WI,19077,220719,239796,55,Wisconsin
2020-05-28,WV,1906,88409,90315,54,West Virginia
2020-05-28,WY,874,22286,23160,56,Wyoming
2020-05-27,AK,412,45951,46363,02,Alaska
2020-05-27,AL,15843,179951,195794,01,Alabama
2020-05-27,AR,6277,109319,115596,05,Arkansas
2020-05-27,AS,0,174,174,60,American Samoa
2020-05-27,AZ,17262,179004,196266,04,Arizona
2020-05-27,CA,98980,1637914,1736894,06,California
2020-05-27,CO,24565,134855,159420,08,Colorado
2020-05-27,CT,41288,187581,228869,09,Connecticut
2020-05-27,DC,8406,34291,42697,11,District of Columbia
2020-05-27,DE,9096,46325,55421,10,Delaware
2020-05-27,FL,52634,880937,933571,12,Florida
2020-05-27,GA,44421,396335,440756,13,Georgia
2020-05-27,GU,170,5515,5685,66,Guam
2020-05-27,HI,643,50559,51202,15,Hawaii
2020-05-27,IA,18360,121166,139526,19,Iowa
2020-05-27,ID,2699,40318,43017,16,Idaho
2020-05-27,IL,114306,689667,803973,17,Illinois
2020-05-27,IN,32437,202896,235333,18,Indiana
2020-05-27,KS,9337,75151,84488,20,Kansas
2020-05-27,KY,9077,173024,182101,21,Kentucky
2020-05-27,LA,38497,309150,347647,22,Louisiana
2020-05-27,MA,94220,457924,552144,25,Massachusetts
2020-05-27,MD,48423,213632,262055,24,Maryland
2020-05-27,ME,2137,43480,45617,23,Maine
2020-05-27,MI,62461,505609,568070,26,Michigan
2020-05-27,MN,24988,222821,247809,27,Minnesota
2020-05-27,MO,12492,153029,165521,29,Missouri
2020-05-27,MP,22,5178,5200,69,Northern Mariana Islands
2020-05-27,MS,14044,134088,148132,28,Mississippi
2020-05-27,MT,481,35162,35643,30,Montana
2020-05-27,NC,24628,339528,364156,37,North Carolina
2020-05-27,ND,2439,64901,67340,38,North Dakota
2020-05-27,NE,12619,77802,90421,31,Nebraska
2020-05-27,NH,4231,60001,64232,33,New Hampshire
2020-05-27,NJ,156628,503697,660325,34,New Jersey
2020-05-27,NM,7130,173516,180646,35,New Mexico
2020-05-27,NV,8113,120446,128559,32,Nevada
2020-05-27,NY,364965,1446579,1811544,36,New York
2020-05-27,OH,33439,316286,349725,39,Ohio
2020-05-27,OK,6229,172409,178638,40,Oklahoma
2020-05-27,OR,4038,112954,116992,41,Oregon
2020-05-27,PA,69417,349990,419407,42,Pennsylvania
2020-05-27,PR,3397,40488,43885,72,Puerto Rico
2020-05-27,RI,14498,93504,108002,44,Rhode Island
2020-05-27,SC,10623,165060,175683,45,South Carolina
2020-05-27,SD,4710,33296,38006,46,South Dakota
2020-05-27,TN,21306,388324,409630,47,Tennessee
2020-05-27,TX,57921,797753,855674,48,Texas
2020-05-27,UT,8706,191920,200626,49,Utah
2020-05-27,VA,40249,236798,277047,51,Virginia
2020-05-27,VI,69,1442,1511,78,U.S. Virgin Islands
2020-05-27,VT,971,30028,30999,50,Vermont
2020-05-27,WA,22483,299378,321861,53,Washington
2020-05-27,WI,18513,210605,229118,55,Wisconsin
2020-05-27,WV,1867,86594,88461,54,West Virginia
2020-05-27,WY,850,20652,21502,56,Wyoming
2020-05-26,AK,411,44553,44964,02,Alaska
2020-05-26,AL,15396,178363,193759,01,Alabama
2020-05-26,AR,6180,105593,111773,05,Arkansas
2020-05-26,AS,0,124,124,60,American Samoa
2020-05-26,AZ,16783,173948,190731,04,Arizona
2020-05-26,CA,96733,1599663,1696396,06,California
2020-05-26,CO,24269,131742,156011,08,Colorado
2020-05-26,CT,41303,184059,225362,09,Connecticut
2020-05-26,DC,8334,33721,42055,11,District of Columbia
2020-05-26,DE,9066,45848,54914,10,Delaware
2020-05-26,FL,52255,870969,923224,12,Florida
2020-05-26,GA,43730,471215,514945,13,Georgia
2020-05-26,GU,169,5515,5684,66,Guam
2020-05-26,HI,643,49728,50371,15,Hawaii
2020-05-26,IA,17703,117301,135004,19,Iowa
2020-05-26,ID,2626,38780,41406,16,Idaho
2020-05-26,IL,113195,673599,786794,17,Illinois
2020-05-26,IN,32078,198671,230749,18,Indiana
2020-05-26,KS,9218,72181,81399,20,Kansas
2020-05-26,KY,8571,161285,169856,21,Kentucky
2020-05-26,LA,38054,302972,341026,22,Louisiana
2020-05-26,MA,93693,451788,545481,25,Massachusetts
2020-05-26,MD,47687,206800,254487,24,Maryland
2020-05-26,ME,2109,35450,37559,23,Maine
2020-05-26,MI,62075,487906,549981,26,Michigan
2020-05-26,MN,24308,213974,238282,27,Minnesota
2020-05-26,MO,12291,148007,160298,29,Missouri
2020-05-26,MP,22,4918,4940,69,Northern Mariana Islands
2020-05-26,MS,13731,134088,147819,28,Mississippi
2020-05-26,MT,479,33355,33834,30,Montana
2020-05-26,NC,24140,328191,352331,37,North Carolina
2020-05-26,ND,2422,64432,66854,38,North Dakota
2020-05-26,NE,12355,75687,88042,31,Nebraska
2020-05-26,NH,4197,58842,63039,33,New Hampshire
2020-05-26,NJ,155764,480128,635892,34,New Jersey
2020-05-26,NM,7026,170335,177361,35,New Mexico
2020-05-26,NV,7997,115370,123367,32,Nevada
2020-05-26,NY,363836,1410292,1774128,36,New York
2020-05-26,OH,33006,306394,339400,39,Ohio
2020-05-26,OK,6137,153804,159941,40,Oklahoma
2020-05-26,OR,3967,111571,115538,41,Oregon
2020-05-26,PA,68637,339835,408472,42,Pennsylvania
2020-05-26,PR,3324,40488,43812,72,Puerto Rico
2020-05-26,RI,14365,92400,106765,44,Rhode Island
2020-05-26,SC,10416,162318,172734,45,South Carolina
2020-05-26,SD,4653,32385,37038,46,South Dakota
2020-05-26,TN,20965,382539,403504,47,Tennessee
2020-05-26,TX,56560,764673,821233,48,Texas
2020-05-26,UT,8620,189972,198592,49,Utah
2020-05-26,VA,39342,227839,267181,51,Virginia
2020-05-26,VI,69,1425,1494,78,U.S. Virgin Islands
2020-05-26,VT,967,29456,30423,50,Vermont
2020-05-26,WA,22184,293934,316118,53,Washington
2020-05-26,WI,17867,200874,218741,55,Wisconsin
2020-05-26,WV,1854,85957,87811,54,West Virginia
2020-05-26,WY,850,20652,21502,56,Wyoming
2020-05-25,AK,409,44063,44472,02,Alaska
2020-05-25,AL,14730,175585,190315,01,Alabama
2020-05-25,AR,6029,105593,111622,05,Arkansas
2020-05-25,AS,0,124,124,60,American Samoa
2020-05-25,AZ,16561,171221,187782,04,Arizona
2020-05-25,CA,94558,1549544,1644102,06,California
2020-05-25,CO,24174,126134,150308,08,Colorado
2020-05-25,CT,40873,180853,221726,09,Connecticut
2020-05-25,DC,8225,32578,40803,11,District of Columbia
2020-05-25,DE,8965,44931,53896,10,Delaware
2020-05-25,FL,51746,856489,908235,12,Florida
2020-05-25,GA,43344,470201,513545,13,Georgia
2020-05-25,GU,166,5403,5569,66,Guam
2020-05-25,HI,643,49728,50371,15,Hawaii
2020-05-25,IA,17577,115138,132715,19,Iowa
2020-05-25,ID,2626,38780,41406,16,Idaho
2020-05-25,IL,112017,657547,769564,17,Illinois
2020-05-25,IN,31715,194536,226251,18,Indiana
2020-05-25,KS,9218,72181,81399,20,Kansas
2020-05-25,KY,8571,161285,169856,21,Kentucky
2020-05-25,LA,37809,293089,330898,22,Louisiana
2020-05-25,MA,93271,447290,540561,25,Massachusetts
2020-05-25,MD,47152,202425,249577,24,Maryland
2020-05-25,ME,2074,35450,37524,23,Maine
2020-05-25,MI,61632,476325,537957,26,Michigan
2020-05-25,MN,23524,207816,231340,27,Minnesota
2020-05-25,MO,12167,145218,157385,29,Missouri
2020-05-25,MP,22,4735,4757,69,Northern Mariana Islands
2020-05-25,MS,13458,130459,143917,28,Mississippi
2020-05-25,MT,479,33203,33682,30,Montana
2020-05-25,NC,23964,320726,344690,37,North Carolina
2020-05-25,ND,2457,63893,66350,38,North Dakota
2020-05-25,NE,12134,73598,85732,31,Nebraska
2020-05-25,NH,4149,57237,61386,33,New Hampshire
2020-05-25,NJ,155092,468705,623797,34,New Jersey
2020-05-25,NM,6943,166538,173481,35,New Mexico
2020-05-25,NV,7879,106852,114731,32,Nevada
2020-05-25,NY,362764,1376685,1739449,36,New York
2020-05-25,OH,32477,297857,330334,39,Ohio
2020-05-25,OK,6090,154943,161033,40,Oklahoma
2020-05-25,OR,3949,109909,113858,41,Oregon
2020-05-25,PA,68186,334928,403114,42,Pennsylvania
2020-05-25,PR,3260,40488,43748,72,Puerto Rico
2020-05-25,RI,14211,90674,104885,44,Rhode Island
2020-05-25,SC,10178,155842,166020,45,South Carolina
2020-05-25,SD,4586,30697,35283,46,South Dakota
2020-05-25,TN,20607,375612,396219,47,Tennessee
2020-05-25,TX,55971,749683,805654,48,Texas
2020-05-25,UT,8521,187947,196468,49,Utah
2020-05-25,VA,37727,221023,258750,51,Virginia
2020-05-25,VI,69,1343,1412,78,U.S. Virgin Islands
2020-05-25,VT,962,28707,29669,50,Vermont
2020-05-25,WA,21909,287314,309223,53,Washington
2020-05-25,WI,17571,193379,210950,55,Wisconsin
2020-05-25,WV,1774,84551,86325,54,West Virginia
2020-05-25,WY,838,19551,20389,56,Wyoming
2020-05-24,AK,408,43099,43507,02,Alaska
2020-05-24,AL,14327,171472,185799,01,Alabama
2020-05-24,AR,5922,102659,108581,05,Arkansas
2020-05-24,AS,0,124,124,60,American Samoa
2020-05-24,AZ,16339,167302,183641,04,Arizona
2020-05-24,CA,92710,1490035,1582745,06,California
2020-05-24,CO,23964,126087,150051,08,Colorado
2020-05-24,CT,40468,173668,214136,09,Connecticut
2020-05-24,DC,7966,44025,51991,11,District of Columbia
2020-05-24,DE,8809,43061,51870,10,Delaware
2020-05-24,FL,50867,820368,871235,12,Florida
2020-05-24,GA,42838,439116,481954,13,Georgia
2020-05-24,GU,166,5403,5569,66,Guam
2020-05-24,HI,643,48929,49572,15,Hawaii
2020-05-24,IA,17252,110504,127756,19,Iowa
2020-05-24,ID,2626,38780,41406,16,Idaho
2020-05-24,IL,110304,637617,747921,17,Illinois
2020-05-24,IN,31376,189425,220801,18,Indiana
2020-05-24,KS,8958,67476,76434,20,Kansas
2020-05-24,KY,8571,161285,169856,21,Kentucky
2020-05-24,LA,37169,278867,316036,22,Louisiana
2020-05-24,MA,92675,439698,532373,25,Massachusetts
2020-05-24,MD,46313,194049,240362,24,Maryland
2020-05-24,ME,2055,35450,37505,23,Maine
2020-05-24,MI,61457,467087,528544,26,Michigan
2020-05-24,MN,23121,201566,224687,27,Minnesota
2020-05-24,MO,11988,139631,151619,29,Missouri
2020-05-24,MP,22,4735,4757,69,Northern Mariana Islands
2020-05-24,MS,13252,124650,137902,28,Mississippi
2020-05-24,MT,479,32902,33381,30,Montana
2020-05-24,NC,23222,313434,336656,37,North Carolina
2020-05-24,ND,2418,63070,65488,38,North Dakota
2020-05-24,NE,11989,71216,83205,31,Nebraska
2020-05-24,NH,4089,55450,59539,33,New Hampshire
2020-05-24,NJ,154154,449653,603807,34,New Jersey
2020-05-24,NM,6795,162324,169119,35,New Mexico
2020-05-24,NV,7770,102511,110281,32,Nevada
2020-05-24,NY,361515,1338311,1699826,36,New York
2020-05-24,OH,31911,292642,324553,39,Ohio
2020-05-24,OK,6037,154943,160980,40,Oklahoma
2020-05-24,OR,3927,108268,112195,41,Oregon
2020-05-24,PA,67713,328382,396095,42,Pennsylvania
2020-05-24,PR,3189,40488,43677,72,Puerto Rico
2020-05-24,RI,14141,89924,104065,44,Rhode Island
2020-05-24,SC,10096,153851,163947,45,South Carolina
2020-05-24,SD,4563,30342,34905,46,South Dakota
2020-05-24,TN,20145,363431,383576,47,Tennessee
2020-05-24,TX,55348,708197,763545,48,Texas
2020-05-24,UT,8392,186041,194433,49,Utah
2020-05-24,VA,36244,207841,244085,51,Virginia
2020-05-24,VI,69,1343,1412,78,U.S. Virgin Islands
2020-05-24,VT,956,27634,28590,50,Vermont
2020-05-24,WA,21652,285088,306740,53,Washington
2020-05-24,WI,17253,186206,203459,55,Wisconsin
2020-05-24,WV,1759,83935,85694,54,West Virginia
2020-05-24,WY,813,19221,20034,56,Wyoming
2020-05-23,AK,408,41943,42351,02,Alaska
2020-05-23,AL,13938,168738,182676,01,Alabama
2020-05-23,AR,5612,97435,103047,05,Arkansas
2020-05-23,AS,0,124,124,60,American Samoa
2020-05-23,AZ,16039,164400,180439,04,Arizona
2020-05-23,CA,90631,1424675,1515306,06,California
2020-05-23,CO,23487,121465,144952,08,Colorado
2020-05-23,CT,40022,168345,208367,09,Connecticut
2020-05-23,DC,7966,44025,51991,11,District of Columbia
2020-05-23,DE,8690,41844,50534,10,Delaware
2020-05-23,FL,50127,806310,856437,12,Florida
2020-05-23,GA,42132,411405,453537,13,Georgia
2020-05-23,GU,165,5194,5359,66,Guam
2020-05-23,HI,642,48179,48821,15,Hawaii
2020-05-23,IA,16893,107048,123941,19,Iowa
2020-05-23,ID,2595,38014,40609,16,Idaho
2020-05-23,IL,107796,614451,722247,17,Illinois
2020-05-23,IN,30901,184032,214933,18,Indiana
2020-05-23,KS,8958,67476,76434,20,Kansas
2020-05-23,KY,8426,163033,171459,21,Kentucky
2020-05-23,LA,37040,277407,314447,22,Louisiana
2020-05-23,MA,91662,429324,520986,25,Massachusetts
2020-05-23,MD,45495,186832,232327,24,Maryland
2020-05-23,ME,2013,35450,37463,23,Maine
2020-05-23,MI,61293,455556,516849,26,Michigan
2020-05-23,MN,22765,194941,217706,27,Minnesota
2020-05-23,MO,11752,136552,148304,29,Missouri
2020-05-23,MP,22,4296,4318,69,Northern Mariana Islands
2020-05-23,MS,13005,121215,134220,28,Mississippi
2020-05-23,MT,479,32173,32652,30,Montana
2020-05-23,NC,22725,306857,329582,37,North Carolina
2020-05-23,ND,2365,61783,64148,38,North Dakota
2020-05-23,NE,11662,68320,79982,31,Nebraska
2020-05-23,NH,4089,55450,59539,33,New Hampshire
2020-05-23,NJ,153104,425631,578735,34,New Jersey
2020-05-23,NM,6625,151758,158383,35,New Mexico
2020-05-23,NV,7696,99351,107047,32,Nevada
2020-05-23,NY,359926,1292135,1652061,36,New York
2020-05-23,OH,31408,285086,316494,39,Ohio
2020-05-23,OK,5960,154943,160903,40,Oklahoma
2020-05-23,OR,3888,106319,110207,41,Oregon
2020-05-23,PA,66983,321469,388452,42,Pennsylvania
2020-05-23,PR,3100,40488,43588,72,Puerto Rico
2020-05-23,RI,14057,89167,103224,44,Rhode Island
2020-05-23,SC,9895,149015,158910,45,South Carolina
2020-05-23,SD,4468,29060,33528,46,South Dakota
2020-05-23,TN,19789,353969,373758,47,Tennessee
2020-05-23,TX,54509,708197,762706,48,Texas
2020-05-23,UT,8260,182519,190779,49,Utah
2020-05-23,VA,35749,196721,232470,51,Virginia
2020-05-23,VI,69,1343,1412,78,U.S. Virgin Islands
2020-05-23,VT,954,26470,27424,50,Vermont
2020-05-23,WA,21492,282906,304398,53,Washington
2020-05-23,WI,16843,179329,196172,55,Wisconsin
2020-05-23,WV,1717,82027,83744,54,West Virginia
2020-05-23,WY,813,19221,20034,56,Wyoming
2020-05-22,AK,404,41042,41446,02,Alaska
2020-05-22,AL,13563,164205,177768,01,Alabama
2020-05-22,AR,5612,97435,103047,05,Arkansas
2020-05-22,AS,0,124,124,60,American Samoa
2020-05-22,AZ,15608,160395,176003,04,Arizona
2020-05-22,CA,88444,1378329,1466773,06,California
2020-05-22,CO,23191,119034,142225,08,Colorado
2020-05-22,CT,39640,162688,202328,09,Connecticut
2020-05-22,DC,7893,35100,42993,11,District of Columbia
2020-05-22,DE,8529,40457,48986,10,Delaware
2020-05-22,FL,49451,786045,835496,12,Florida
2020-05-22,GA,41218,386031,427249,13,Georgia
2020-05-22,GU,165,5114,5279,66,Guam
2020-05-22,HI,647,47338,47985,15,Hawaii
2020-05-22,IA,16504,103746,120250,19,Iowa
2020-05-22,ID,2534,37061,39595,16,Idaho
2020-05-22,IL,105444,591689,697133,17,Illinois
2020-05-22,IN,30409,178152,208561,18,Indiana
2020-05-22,KS,8958,67476,76434,20,Kansas
2020-05-22,KY,8286,157954,166240,21,Kentucky
2020-05-22,LA,36925,274883,311808,22,Louisiana
2020-05-22,MA,90889,420755,511644,25,Massachusetts
2020-05-22,MD,44424,183478,227902,24,Maryland
2020-05-22,ME,1948,35450,37398,23,Maine
2020-05-22,MI,61075,441282,502357,26,Michigan
2020-05-22,MN,22374,186436,208810,27,Minnesota
2020-05-22,MO,11558,161388,172946,29,Missouri
2020-05-22,MP,22,4296,4318,69,Northern Mariana Islands
2020-05-22,MS,12624,125349,137973,28,Mississippi
2020-05-22,MT,479,31378,31857,30,Montana
2020-05-22,NC,21618,281606,303224,37,North Carolina
2020-05-22,ND,2317,60513,62830,38,North Dakota
2020-05-22,NE,11425,66994,78419,31,Nebraska
2020-05-22,NH,3935,51165,55100,33,New Hampshire
2020-05-22,NJ,152719,402595,555314,34,New Jersey
2020-05-22,NM,6472,146295,152767,35,New Mexico
2020-05-22,NV,7401,92540,99941,32,Nevada
2020-05-22,NY,358154,1242639,1600793,36,New York
2020-05-22,OH,30794,277006,307800,39,Ohio
2020-05-22,OK,5849,147318,153167,40,Oklahoma
2020-05-22,OR,3864,103975,107839,41,Oregon
2020-05-22,PA,66258,312743,379001,42,Pennsylvania
2020-05-22,PR,3030,40488,43518,72,Puerto Rico
2020-05-22,RI,13949,87850,101799,44,Rhode Island
2020-05-22,SC,9638,140385,150023,45,South Carolina
2020-05-22,SD,4356,27988,32344,46,South Dakota
2020-05-22,TN,19394,348776,368170,47,Tennessee
2020-05-22,TX,53449,687913,741362,48,Texas
2020-05-22,UT,8057,178777,186834,49,Utah
2020-05-22,VA,34950,190225,225175,51,Virginia
2020-05-22,VI,69,1343,1412,78,U.S. Virgin Islands
2020-05-22,VT,952,24781,25733,50,Vermont
2020-05-22,WA,21283,280444,301727,53,Washington
2020-05-22,WI,16340,172703,189043,55,Wisconsin
2020-05-22,WV,1616,83213,84829,54,West Virginia
2020-05-22,WY,803,18621,19424,56,Wyoming
2020-05-21,AK,402,39143,39545,02,Alaska
2020-05-21,AL,13119,157620,170739,01,Alabama
2020-05-21,AR,5458,93818,99276,05,Arkansas
2020-05-21,AS,0,124,124,60,American Samoa
2020-05-21,AZ,15315,156312,171627,04,Arizona
2020-05-21,CA,86197,1334930,1421127,06,California
2020-05-21,CO,22797,112814,135611,08,Colorado
2020-05-21,CT,39208,157239,196447,09,Connecticut
2020-05-21,DC,7788,33968,41756,11,District of Columbia
2020-05-21,DE,8386,39156,47542,10,Delaware
2020-05-21,FL,48675,765254,813929,12,Florida
2020-05-21,GA,40405,367326,407731,13,Georgia
2020-05-21,GU,165,4899,5064,66,Guam
2020-05-21,HI,643,46506,47149,15,Hawaii
2020-05-21,IA,16170,100395,116565,19,Iowa
2020-05-21,ID,2506,36382,38888,16,Idaho
2020-05-21,IL,102686,569334,672020,17,Illinois
2020-05-21,IN,29936,173059,202995,18,Indiana
2020-05-21,KS,8539,62664,71203,20,Kansas
2020-05-21,KY,8167,150505,158672,21,Kentucky
2020-05-21,LA,36504,268877,305381,22,Louisiana
2020-05-21,MA,90084,411402,501486,25,Massachusetts
2020-05-21,MD,43531,176702,220233,24,Maryland
2020-05-21,ME,1877,35450,37327,23,Maine
2020-05-21,MI,60610,421788,482398,26,Michigan
2020-05-21,MN,21582,177506,199088,27,Minnesota
2020-05-21,MO,11340,150752,162092,29,Missouri
2020-05-21,MP,22,4067,4089,69,Northern Mariana Islands
2020-05-21,MS,12222,113748,125970,28,Mississippi
2020-05-21,MT,479,30045,30524,30,Montana
2020-05-21,NC,20860,269785,290645,37,North Carolina
2020-05-21,ND,2229,59050,61279,38,North Dakota
2020-05-21,NE,11122,64518,75640,31,Nebraska
2020-05-21,NH,3868,48962,52830,33,New Hampshire
2020-05-21,NJ,151472,392802,544274,34,New Jersey
2020-05-21,NM,6317,141027,147344,35,New Mexico
2020-05-21,NV,7255,87127,94382,32,Nevada
2020-05-21,NY,356458,1198597,1555055,36,New York
2020-05-21,OH,30167,268911,299078,39,Ohio
2020-05-21,OK,5680,143915,149595,40,Oklahoma
2020-05-21,OR,3817,101407,105224,41,Oregon
2020-05-21,PA,65392,303514,368906,42,Pennsylvania
2020-05-21,PR,2913,40488,43401,72,Puerto Rico
2020-05-21,RI,13748,86399,100147,44,Rhode Island
2020-05-21,SC,9175,129063,138238,45,South Carolina
2020-05-21,SD,4250,27051,31301,46,South Dakota
2020-05-21,TN,18961,341622,360583,47,Tennessee
2020-05-21,TX,52268,687913,740181,48,Texas
2020-05-21,UT,7874,175000,182874,49,Utah
2020-05-21,VA,34137,184462,218599,51,Virginia
2020-05-21,VI,69,1314,1383,78,U.S. Virgin Islands
2020-05-21,VT,950,24751,25701,50,Vermont
2020-05-21,WA,20988,276171,297159,53,Washington
2020-05-21,WI,15792,163238,179030,55,Wisconsin
2020-05-21,WV,1593,81548,83141,54,West Virginia
2020-05-21,WY,787,18053,18840,56,Wyoming
2020-05-20,AK,402,36643,37045,02,Alaska
2020-05-20,AL,12744,151706,164450,01,Alabama
2020-05-20,AR,5003,91255,96258,05,Arkansas
2020-05-20,AS,0,124,124,60,American Samoa
2020-05-20,AZ,14897,150538,165435,04,Arizona
2020-05-20,CA,84057,1296063,1380120,06,California
2020-05-20,CO,22482,109355,131837,08,Colorado
2020-05-20,CT,39017,151701,190718,09,Connecticut
2020-05-20,DC,7551,32868,40419,11,District of Columbia
2020-05-20,DE,8194,37218,45412,10,Delaware
2020-05-20,FL,47471,723877,771348,12,Florida
2020-05-20,GA,39647,363293,402940,13,Georgia
2020-05-20,GU,165,4807,4972,66,Guam
2020-05-20,HI,641,45663,46304,15,Hawaii
2020-05-20,IA,15614,95134,110748,19,Iowa
2020-05-20,ID,2476,36091,38567,16,Idaho
2020-05-20,IL,100418,542295,642713,17,Illinois
2020-05-20,IN,29274,166464,195738,18,Indiana
2020-05-20,KS,8539,62664,71203,20,Kansas
2020-05-20,KY,8069,145917,153986,21,Kentucky
2020-05-20,LA,35316,250654,285970,22,Louisiana
2020-05-20,MA,88970,400983,489953,25,Massachusetts
2020-05-20,MD,42323,173007,215330,24,Maryland
2020-05-20,ME,1819,35450,37269,23,Maine
2020-05-20,MI,60151,405848,465999,26,Michigan
2020-05-20,MN,20609,170199,190808,27,Minnesota
2020-05-20,MO,11232,150752,161984,29,Missouri
2020-05-20,MP,21,3796,3817,69,Northern Mariana Islands
2020-05-20,MS,11967,108713,120680,28,Mississippi
2020-05-20,MT,478,29248,29726,30,Montana
2020-05-20,NC,20122,257481,277603,37,North Carolina
2020-05-20,ND,2095,57105,59200,38,North Dakota
2020-05-20,NE,10846,61289,72135,31,Nebraska
2020-05-20,NH,3721,47167,50888,33,New Hampshire
2020-05-20,NJ,150399,380944,531343,34,New Jersey
2020-05-20,NM,6192,136054,142246,35,New Mexico
2020-05-20,NV,7166,84005,91171,32,Nevada
2020-05-20,NY,354370,1151466,1505836,36,New York
2020-05-20,OH,29436,260092,289528,39,Ohio
2020-05-20,OK,5532,138839,144371,40,Oklahoma
2020-05-20,OR,3801,98348,102149,41,Oregon
2020-05-20,PA,63666,286034,349700,42,Pennsylvania
2020-05-20,PR,2866,NA,2866,72,Puerto Rico
2020-05-20,RI,13579,84460,98039,44,Rhode Island
2020-05-20,SC,9056,126007,135063,45,South Carolina
2020-05-20,SD,4177,26212,30389,46,South Dakota
2020-05-20,TN,18532,335481,354013,47,Tennessee
2020-05-20,TX,51323,669605,720928,48,Texas
2020-05-20,UT,7710,171954,179664,49,Utah
2020-05-20,VA,32908,179718,212626,51,Virginia
2020-05-20,VI,69,1314,1383,78,U.S. Virgin Islands
2020-05-20,VT,944,24114,25058,50,Vermont
2020-05-20,WA,20784,271703,292487,53,Washington
2020-05-20,WI,15269,154300,169569,55,Wisconsin
2020-05-20,WV,1545,79096,80641,54,West Virginia
2020-05-20,WY,787,18053,18840,56,Wyoming
2020-05-19,AK,399,35981,36380,02,Alaska
2020-05-19,AL,12376,145190,157566,01,Alabama
2020-05-19,AR,4923,88778,93701,05,Arkansas
2020-05-19,AS,0,124,124,60,American Samoa
2020-05-19,AZ,14566,147005,161571,04,Arizona
2020-05-19,CA,81795,1257521,1339316,06,California
2020-05-19,CO,22202,109131,131333,08,Colorado
2020-05-19,CT,38430,147090,185520,09,Connecticut
2020-05-19,DC,7434,31940,39374,11,District of Columbia
2020-05-19,DE,8037,36095,44132,10,Delaware
2020-05-19,FL,46944,668911,715855,12,Florida
2020-05-19,GA,38721,339435,378156,13,Georgia
2020-05-19,GU,154,4673,4827,66,Guam
2020-05-19,HI,640,44383,45023,15,Hawaii
2020-05-19,IA,15349,92299,107648,19,Iowa
2020-05-19,ID,2455,35614,38069,16,Idaho
2020-05-19,IL,98030,523654,621684,17,Illinois
2020-05-19,IN,28705,160625,189330,18,Indiana
2020-05-19,KS,8340,58650,66990,20,Kansas
2020-05-19,KY,8069,145917,153986,21,Kentucky
2020-05-19,LA,35038,243035,278073,22,Louisiana
2020-05-19,MA,87925,389015,476940,25,Massachusetts
2020-05-19,MD,41546,167112,208658,24,Maryland
2020-05-19,ME,1741,22092,23833,23,Maine
2020-05-19,MI,59576,392208,451784,26,Michigan
2020-05-19,MN,19842,164009,183851,27,Minnesota
2020-05-19,MO,11080,143030,154110,29,Missouri
2020-05-19,MP,21,3796,3817,69,Northern Mariana Islands
2020-05-19,MS,11704,106056,117760,28,Mississippi
2020-05-19,MT,471,28479,28950,30,Montana
2020-05-19,NC,19700,245308,265008,37,North Carolina
2020-05-19,ND,1994,55737,57731,38,North Dakota
2020-05-19,NE,10625,59359,69984,31,Nebraska
2020-05-19,NH,3652,45822,49474,33,New Hampshire
2020-05-19,NJ,149013,371169,520182,34,New Jersey
2020-05-19,NM,6096,131524,137620,35,New Mexico
2020-05-19,NV,7046,80509,87555,32,Nevada
2020-05-19,NY,352845,1114894,1467739,36,New York
2020-05-19,OH,28952,248650,277602,39,Ohio
2020-05-19,OK,5489,133658,139147,40,Oklahoma
2020-05-19,OR,3726,95994,99720,41,Oregon
2020-05-19,PA,63666,286034,349700,42,Pennsylvania
2020-05-19,PR,2805,NA,2805,72,Puerto Rico
2020-05-19,RI,13392,82935,96327,44,Rhode Island
2020-05-19,SC,9056,126007,135063,45,South Carolina
2020-05-19,SD,4085,25624,29709,46,South Dakota
2020-05-19,TN,18378,327745,346123,47,Tennessee
2020-05-19,TX,49912,650234,700146,48,Texas
2020-05-19,UT,7518,169793,177311,49,Utah
2020-05-19,VA,32145,170644,202789,51,Virginia
2020-05-19,VI,69,1298,1367,78,U.S. Virgin Islands
2020-05-19,VT,944,24114,25058,50,Vermont
2020-05-19,WA,20535,266314,286849,53,Washington
2020-05-19,WI,14692,148237,162929,55,Wisconsin
2020-05-19,WV,1509,76792,78301,54,West Virginia
2020-05-19,WY,766,17084,17850,56,Wyoming
2020-05-18,AK,399,35212,35611,02,Alaska
2020-05-18,AL,12086,145037,157123,01,Alabama
2020-05-18,AR,4813,80426,85239,05,Arkansas
2020-05-18,AS,0,105,105,60,American Samoa
2020-05-18,AZ,14170,142303,156473,04,Arizona
2020-05-18,CA,80430,1212242,1292672,06,California
2020-05-18,CO,21938,106557,128495,08,Colorado
2020-05-18,CT,38116,139563,177679,09,Connecticut
2020-05-18,DC,7270,30555,37825,11,District of Columbia
2020-05-18,DE,7869,34589,42458,10,Delaware
2020-05-18,FL,46442,629970,676412,12,Florida
2020-05-18,GA,38081,326208,364289,13,Georgia
2020-05-18,GU,154,4569,4723,66,Guam
2020-05-18,HI,640,41405,42045,15,Hawaii
2020-05-18,IA,14955,88193,103148,19,Iowa
2020-05-18,ID,2419,34253,36672,16,Idaho
2020-05-18,IL,96485,506756,603241,17,Illinois
2020-05-18,IN,28255,155657,183912,18,Indiana
2020-05-18,KS,8340,58650,66990,20,Kansas
2020-05-18,KY,7688,121997,129685,21,Kentucky
2020-05-18,LA,34709,235039,269748,22,Louisiana
2020-05-18,MA,87052,382147,469199,25,Massachusetts
2020-05-18,MD,39762,161744,201506,24,Maryland
2020-05-18,ME,1713,22092,23805,23,Maine
2020-05-18,MI,58812,376115,434927,26,Michigan
2020-05-18,MN,18987,158487,177474,27,Minnesota
2020-05-18,MO,10945,140393,151338,29,Missouri
2020-05-18,MP,21,3399,3420,69,Northern Mariana Islands
2020-05-18,MS,11432,104335,115767,28,Mississippi
2020-05-18,MT,470,27697,28167,30,Montana
2020-05-18,NC,19023,236732,255755,37,North Carolina
2020-05-18,ND,1931,54630,56561,38,North Dakota
2020-05-18,NE,10348,57153,67501,31,Nebraska
2020-05-18,NH,3596,41282,44878,33,New Hampshire
2020-05-18,NJ,148039,357530,505569,34,New Jersey
2020-05-18,NM,5938,127315,133253,35,New Mexico
2020-05-18,NV,6906,74926,81832,32,Nevada
2020-05-18,NY,351371,1088186,1439557,36,New York
2020-05-18,OH,28454,243395,271849,39,Ohio
2020-05-18,OK,5398,118162,123560,40,Oklahoma
2020-05-18,OR,3687,93628,97315,41,Oregon
2020-05-18,PA,63056,277553,340609,42,Pennsylvania
2020-05-18,PR,2710,NA,2710,72,Puerto Rico
2020-05-18,RI,13177,81057,94234,44,Rhode Island
2020-05-18,SC,8942,122617,131559,45,South Carolina
2020-05-18,SD,4027,25018,29045,46,South Dakota
2020-05-18,TN,18011,319417,337428,47,Tennessee
2020-05-18,TX,48693,631152,679845,48,Texas
2020-05-18,UT,7384,166638,174022,49,Utah
2020-05-18,VA,31140,165086,196226,51,Virginia
2020-05-18,VI,69,1278,1347,78,U.S. Virgin Islands
2020-05-18,VT,944,23547,24491,50,Vermont
2020-05-18,WA,20286,259467,279753,53,Washington
2020-05-18,WI,14442,144502,158944,55,Wisconsin
2020-05-18,WV,1491,74544,76035,54,West Virginia
2020-05-18,WY,754,16331,17085,56,Wyoming
2020-05-17,AK,396,34255,34651,02,Alaska
2020-05-17,AL,11771,144579,156350,01,Alabama
2020-05-17,AR,4759,80426,85185,05,Arkansas
2020-05-17,AS,0,105,105,60,American Samoa
2020-05-17,AZ,13937,137824,151761,04,Arizona
2020-05-17,CA,78839,1156404,1235243,06,California
2020-05-17,CO,21633,103915,125548,08,Colorado
2020-05-17,CT,37419,133188,170607,09,Connecticut
2020-05-17,DC,7123,29403,36526,11,District of Columbia
2020-05-17,DE,7670,33195,40865,10,Delaware
2020-05-17,FL,45588,606204,651792,12,Florida
2020-05-17,GA,37701,313474,351175,13,Georgia
2020-05-17,GU,154,4450,4604,66,Guam
2020-05-17,HI,639,41035,41674,15,Hawaii
2020-05-17,IA,14651,85590,100241,19,Iowa
2020-05-17,ID,2419,34253,36672,16,Idaho
2020-05-17,IL,94191,487753,581944,17,Illinois
2020-05-17,IN,27778,149465,177243,18,Indiana
2020-05-17,KS,7886,53706,61592,20,Kansas
2020-05-17,KY,7688,121997,129685,21,Kentucky
2020-05-17,LA,34432,230738,265170,22,Louisiana
2020-05-17,MA,86010,374816,460826,25,Massachusetts
2020-05-17,MD,38804,156122,194926,24,Maryland
2020-05-17,ME,1687,22092,23779,23,Maine
2020-05-17,MI,58278,363548,421826,26,Michigan
2020-05-17,MN,18016,153069,171085,27,Minnesota
2020-05-17,MO,10789,135466,146255,29,Missouri
2020-05-17,MP,21,3318,3339,69,Northern Mariana Islands
2020-05-17,MS,11296,101830,113126,28,Mississippi
2020-05-17,MT,468,26417,26885,30,Montana
2020-05-17,NC,18512,230432,248944,37,North Carolina
2020-05-17,ND,1900,53321,55221,38,North Dakota
2020-05-17,NE,10220,55420,65640,31,Nebraska
2020-05-17,NH,3556,41196,44752,33,New Hampshire
2020-05-17,NJ,146334,341231,487565,34,New Jersey
2020-05-17,NM,5857,122727,128584,35,New Mexico
2020-05-17,NV,6857,73780,80637,32,Nevada
2020-05-17,NY,350121,1063275,1413396,36,New York
2020-05-17,OH,27923,236539,264462,39,Ohio
2020-05-17,OK,5310,118162,123472,40,Oklahoma
2020-05-17,OR,3623,90733,94356,41,Oregon
2020-05-17,PA,62234,270670,332904,42,Pennsylvania
2020-05-17,PR,2646,NA,2646,72,Puerto Rico
2020-05-17,RI,13040,79768,92808,44,Rhode Island
2020-05-17,SC,8816,111670,120486,45,South Carolina
2020-05-17,SD,3987,24572,28559,46,South Dakota
2020-05-17,TN,17388,307892,325280,47,Tennessee
2020-05-17,TX,47784,602571,650355,48,Texas
2020-05-17,UT,7238,163514,170752,49,Utah
2020-05-17,VA,30388,159973,190361,51,Virginia
2020-05-17,VI,69,1278,1347,78,U.S. Virgin Islands
2020-05-17,VT,940,22974,23914,50,Vermont
2020-05-17,WA,19991,252780,272771,53,Washington
2020-05-17,WI,14257,139674,153931,55,Wisconsin
2020-05-17,WV,1490,74000,75490,54,West Virginia
2020-05-17,WY,754,16331,17085,56,Wyoming
2020-05-16,AK,392,32889,33281,02,Alaska
2020-05-16,AL,11523,141971,153494,01,Alabama
2020-05-16,AR,4578,77066,81644,05,Arkansas
2020-05-16,AS,0,105,105,60,American Samoa
2020-05-16,AZ,13631,133157,146788,04,Arizona
2020-05-16,CA,76793,1102333,1179126,06,California
2020-05-16,CO,21232,100608,121840,08,Colorado
2020-05-16,CT,36703,128052,164755,09,Connecticut
2020-05-16,DC,7042,28490,35532,11,District of Columbia
2020-05-16,DE,7547,32211,39758,10,Delaware
2020-05-16,FL,44811,585236,630047,12,Florida
2020-05-16,GA,37147,283922,321069,13,Georgia
2020-05-16,GU,154,4365,4519,66,Guam
2020-05-16,HI,638,40245,40883,15,Hawaii
2020-05-16,IA,14328,81972,96300,19,Iowa
2020-05-16,ID,2389,33299,35688,16,Idaho
2020-05-16,IL,92457,469192,561649,17,Illinois
2020-05-16,IN,27280,144078,171358,18,Indiana
2020-05-16,KS,7886,53706,61592,20,Kansas
2020-05-16,KY,7444,120290,127734,21,Kentucky
2020-05-16,LA,34117,225625,259742,22,Louisiana
2020-05-16,MA,84933,363156,448089,25,Massachusetts
2020-05-16,MD,37968,152207,190175,24,Maryland
2020-05-16,ME,1648,22092,23740,23,Maine
2020-05-16,MI,58023,353156,411179,26,Michigan
2020-05-16,MN,17705,147399,165104,27,Minnesota
2020-05-16,MO,10675,128665,139340,29,Missouri
2020-05-16,MP,21,3318,3339,69,Northern Mariana Islands
2020-05-16,MS,11123,97353,108476,28,Mississippi
2020-05-16,MT,468,25623,26091,30,Montana
2020-05-16,NC,17982,220604,238586,37,North Carolina
2020-05-16,ND,1848,51639,53487,38,North Dakota
2020-05-16,NE,9772,50206,59978,31,Nebraska
2020-05-16,NH,3464,39212,42676,33,New Hampshire
2020-05-16,NJ,145089,330135,475224,34,New Jersey
2020-05-16,NM,5662,118796,124458,35,New Mexico
2020-05-16,NV,6662,67002,73664,32,Nevada
2020-05-16,NY,348232,1030485,1378717,36,New York
2020-05-16,OH,27474,219228,246702,39,Ohio
2020-05-16,OK,5237,118162,123399,40,Oklahoma
2020-05-16,OR,3612,88587,92199,41,Oregon
2020-05-16,PA,61611,266225,327836,42,Pennsylvania
2020-05-16,PR,2589,NA,2589,72,Puerto Rico
2020-05-16,RI,12915,78231,91146,44,Rhode Island
2020-05-16,SC,8407,101209,109616,45,South Carolina
2020-05-16,SD,3959,24217,28176,46,South Dakota
2020-05-16,TN,17288,302913,320201,47,Tennessee
2020-05-16,TX,46999,591740,638739,48,Texas
2020-05-16,UT,7068,159706,166774,49,Utah
2020-05-16,VA,29683,155885,185568,51,Virginia
2020-05-16,VI,69,1194,1263,78,U.S. Virgin Islands
2020-05-16,VT,940,22197,23137,50,Vermont
2020-05-16,WA,19838,250963,270801,53,Washington
2020-05-16,WI,13878,134206,148084,55,Wisconsin
2020-05-16,WV,1457,71936,73393,54,West Virginia
2020-05-16,WY,716,15678,16394,56,Wyoming
2020-05-15,AK,388,32030,32418,02,Alaska
2020-05-15,AL,11216,134847,146063,01,Alabama
2020-05-15,AR,4463,77066,81529,05,Arkansas
2020-05-15,AS,0,105,105,60,American Samoa
2020-05-15,AZ,13169,128832,142001,04,Arizona
2020-05-15,CA,74936,1058970,1133906,06,California
2020-05-15,CO,20838,97192,118030,08,Colorado
2020-05-15,CT,36085,119823,155908,09,Connecticut
2020-05-15,DC,6871,27468,34339,11,District of Columbia
2020-05-15,DE,7373,30905,38278,10,Delaware
2020-05-15,FL,43210,565627,608837,12,Florida
2020-05-15,GA,36681,265193,301874,13,Georgia
2020-05-15,GU,154,4361,4515,66,Guam
2020-05-15,HI,637,38139,38776,15,Hawaii
2020-05-15,IA,14049,79517,93566,19,Iowa
2020-05-15,ID,2351,32394,34745,16,Idaho
2020-05-15,IL,90369,448233,538602,17,Illinois
2020-05-15,IN,26655,138793,165448,18,Indiana
2020-05-15,KS,7886,53706,61592,20,Kansas
2020-05-15,KY,7225,114053,121278,21,Kentucky
2020-05-15,LA,33837,219352,253189,22,Louisiana
2020-05-15,MA,83421,352258,435679,25,Massachusetts
2020-05-15,MD,36986,145840,182826,24,Maryland
2020-05-15,ME,1603,22092,23695,23,Maine
2020-05-15,MI,57687,341827,399514,26,Michigan
2020-05-15,MN,17363,139773,157136,27,Minnesota
2020-05-15,MO,10456,124002,134458,29,Missouri
2020-05-15,MP,19,3306,3325,69,Northern Mariana Islands
2020-05-15,MS,10801,96022,106823,28,Mississippi
2020-05-15,MT,466,24952,25418,30,Montana
2020-05-15,NC,17129,214418,231547,37,North Carolina
2020-05-15,ND,1761,49954,51715,38,North Dakota
2020-05-15,NE,9416,47799,57215,31,Nebraska
2020-05-15,NH,3464,39148,42612,33,New Hampshire
2020-05-15,NJ,143905,319067,462972,34,New Jersey
2020-05-15,NM,5503,114098,119601,35,New Mexico
2020-05-15,NV,6614,65532,72146,32,Nevada
2020-05-15,NY,345813,992235,1338048,36,New York
2020-05-15,OH,26954,219228,246182,39,Ohio
2020-05-15,OK,5086,113106,118192,40,Oklahoma
2020-05-15,OR,3541,85965,89506,41,Oregon
2020-05-15,PA,60622,259210,319832,42,Pennsylvania
2020-05-15,PR,2542,NA,2542,72,Puerto Rico
2020-05-15,RI,12663,76467,89130,44,Rhode Island
2020-05-15,SC,8407,101209,109616,45,South Carolina
2020-05-15,SD,3887,23527,27414,46,South Dakota
2020-05-15,TN,16970,292786,309756,47,Tennessee
2020-05-15,TX,45198,564432,609630,48,Texas
2020-05-15,UT,6913,156305,163218,49,Utah
2020-05-15,VA,28672,149342,178014,51,Virginia
2020-05-15,VI,69,1194,1263,78,U.S. Virgin Islands
2020-05-15,VT,932,21237,22169,50,Vermont
2020-05-15,WA,19650,248322,267972,53,Washington
2020-05-15,WI,13344,128657,142001,55,Wisconsin
2020-05-15,WV,1441,69495,70936,54,West Virginia
2020-05-15,WY,715,15307,16022,56,Wyoming
2020-05-14,AK,387,31375,31762,02,Alaska
2020-05-14,AL,10968,131017,141985,01,Alabama
2020-05-14,AR,4236,71582,75818,05,Arkansas
2020-05-14,AS,0,105,105,60,American Samoa
2020-05-14,AZ,12674,121664,134338,04,Arizona
2020-05-14,CA,73164,1031487,1104651,06,California
2020-05-14,CO,20475,94044,114519,08,Colorado
2020-05-14,CT,35464,114098,149562,09,Connecticut
2020-05-14,DC,6736,26263,32999,11,District of Columbia
2020-05-14,DE,7223,29634,36857,10,Delaware
2020-05-14,FL,43210,565627,608837,12,Florida
2020-05-14,GA,35858,250023,285881,13,Georgia
2020-05-14,GU,153,4226,4379,66,Guam
2020-05-14,HI,638,38243,38881,15,Hawaii
2020-05-14,IA,13675,75619,89294,19,Iowa
2020-05-14,ID,2324,31430,33754,16,Idaho
2020-05-14,IL,87937,424100,512037,17,Illinois
2020-05-14,IN,26053,134186,160239,18,Indiana
2020-05-14,KS,7468,50160,57628,20,Kansas
2020-05-14,KY,7080,110315,117395,21,Kentucky
2020-05-14,LA,33489,214099,247588,22,Louisiana
2020-05-14,MA,82182,342179,424361,25,Massachusetts
2020-05-14,MD,35903,142551,178454,24,Maryland
2020-05-14,ME,1565,22092,23657,23,Maine
2020-05-14,MI,57036,326657,383693,26,Michigan
2020-05-14,MN,16565,131443,148008,27,Minnesota
2020-05-14,MO,10317,116793,127110,29,Missouri
2020-05-14,MP,19,3306,3325,69,Northern Mariana Islands
2020-05-14,MS,10483,94843,105326,28,Mississippi
2020-05-14,MT,462,24087,24549,30,Montana
2020-05-14,NC,16507,202761,219268,37,North Carolina
2020-05-14,ND,1647,48599,50246,38,North Dakota
2020-05-14,NE,9075,44266,53341,31,Nebraska
2020-05-14,NH,3299,35876,39175,33,New Hampshire
2020-05-14,NJ,142704,308992,451696,34,New Jersey
2020-05-14,NM,5364,109647,115011,35,New Mexico
2020-05-14,NV,6499,62985,69484,32,Nevada
2020-05-14,NY,343051,955706,1298757,36,New York
2020-05-14,OH,26357,206995,233352,39,Ohio
2020-05-14,OK,4962,107221,112183,40,Oklahoma
2020-05-14,OR,3479,80571,84050,41,Oregon
2020-05-14,PA,59636,251559,311195,42,Pennsylvania
2020-05-14,PR,2427,NA,2427,72,Puerto Rico
2020-05-14,RI,12431,74767,87198,44,Rhode Island
2020-05-14,SC,8189,94346,102535,45,South Carolina
2020-05-14,SD,3792,22681,26473,46,South Dakota
2020-05-14,TN,16699,285618,302317,47,Tennessee
2020-05-14,TX,43851,543462,587313,48,Texas
2020-05-14,UT,6749,153370,160119,49,Utah
2020-05-14,VA,27813,139017,166830,51,Virginia
2020-05-14,VI,69,1164,1233,78,U.S. Virgin Islands
2020-05-14,VT,931,20497,21428,50,Vermont
2020-05-14,WA,19424,243144,262568,53,Washington
2020-05-14,WI,12869,122598,135467,55,Wisconsin
2020-05-14,WV,1427,67286,68713,54,West Virginia
2020-05-14,WY,701,14729,15430,56,Wyoming
2020-05-13,AK,383,30266,30649,02,Alaska
2020-05-13,AL,10617,125755,136372,01,Alabama
2020-05-13,AR,4164,69051,73215,05,Arkansas
2020-05-13,AS,0,105,105,60,American Samoa
2020-05-13,AZ,12176,115574,127750,04,Arizona
2020-05-13,CA,71141,994451,1065592,06,California
2020-05-13,CO,20157,91093,111250,08,Colorado
2020-05-13,CT,34855,108088,142943,09,Connecticut
2020-05-13,DC,6584,25074,31658,11,District of Columbia
2020-05-13,DE,6952,27801,34753,10,Delaware
2020-05-13,FL,42402,552361,594763,12,Florida
2020-05-13,GA,35332,238572,273904,13,Georgia
2020-05-13,GU,152,4110,4262,66,Guam
2020-05-13,HI,635,37730,38365,15,Hawaii
2020-05-13,IA,13289,72430,85719,19,Iowa
2020-05-13,ID,2293,30835,33128,16,Idaho
2020-05-13,IL,84698,404661,489359,17,Illinois
2020-05-13,IN,25473,128610,154083,18,Indiana
2020-05-13,KS,7468,50160,57628,20,Kansas
2020-05-13,KY,6853,103781,110634,21,Kentucky
2020-05-13,LA,32662,205242,237904,22,Louisiana
2020-05-13,MA,80497,329535,410032,25,Massachusetts
2020-05-13,MD,34812,138762,173574,24,Maryland
2020-05-13,ME,1515,22092,23607,23,Maine
2020-05-13,MI,56458,310242,366700,26,Michigan
2020-05-13,MN,15772,125502,141274,27,Minnesota
2020-05-13,MO,10142,114000,124142,29,Missouri
2020-05-13,MP,19,3021,3040,69,Northern Mariana Islands
2020-05-13,MS,10090,89958,100048,28,Mississippi
2020-05-13,MT,462,23390,23852,30,Montana
2020-05-13,NC,15816,194641,210457,37,North Carolina
2020-05-13,ND,1647,47298,48945,38,North Dakota
2020-05-13,NE,8692,41033,49725,31,Nebraska
2020-05-13,NH,3239,33977,37216,33,New Hampshire
2020-05-13,NJ,141560,299890,441450,34,New Jersey
2020-05-13,NM,5212,105077,110289,35,New Mexico
2020-05-13,NV,6394,60278,66672,32,Nevada
2020-05-13,NY,340661,918246,1258907,36,New York
2020-05-13,OH,25721,200133,225854,39,Ohio
2020-05-13,OK,4852,104275,109127,40,Oklahoma
2020-05-13,OR,3416,80571,83987,41,Oregon
2020-05-13,PA,58698,244171,302869,42,Pennsylvania
2020-05-13,PR,2329,NA,2329,72,Puerto Rico
2020-05-13,RI,12203,72840,85043,44,Rhode Island
2020-05-13,SC,7927,85213,93140,45,South Carolina
2020-05-13,SD,3732,22112,25844,46,South Dakota
2020-05-13,TN,16370,276547,292917,47,Tennessee
2020-05-13,TX,42403,514373,556776,48,Texas
2020-05-13,UT,6620,150166,156786,49,Utah
2020-05-13,VA,26746,134646,161392,51,Virginia
2020-05-13,VI,69,1128,1197,78,U.S. Virgin Islands
2020-05-13,VT,930,19708,20638,50,Vermont
2020-05-13,WA,19179,238384,257563,53,Washington
2020-05-13,WI,12449,117111,129560,55,Wisconsin
2020-05-13,WV,1398,65282,66680,54,West Virginia
2020-05-13,WY,675,14384,15059,56,Wyoming
2020-05-12,AK,383,29578,29961,02,Alaska
2020-05-12,AL,10310,122908,133218,01,Alabama
2020-05-12,AR,4164,66280,70444,05,Arkansas
2020-05-12,AS,0,105,105,60,American Samoa
2020-05-12,AZ,11736,111106,122842,04,Arizona
2020-05-12,CA,69382,963988,1033370,06,California
2020-05-12,CO,19879,88778,108657,08,Colorado
2020-05-12,CT,34333,104091,138424,09,Connecticut
2020-05-12,DC,6485,24565,31050,11,District of Columbia
2020-05-12,DE,6741,26550,33291,10,Delaware
2020-05-12,FL,41923,537681,579604,12,Florida
2020-05-12,GA,34635,227544,262179,13,Georgia
2020-05-12,GU,152,3939,4091,66,Guam
2020-05-12,HI,634,37305,37939,15,Hawaii
2020-05-12,IA,12912,68376,81288,19,Iowa
2020-05-12,ID,2260,30445,32705,16,Idaho
2020-05-12,IL,83021,388670,471691,17,Illinois
2020-05-12,IN,25127,125383,150510,18,Indiana
2020-05-12,KS,7116,46993,54109,20,Kansas
2020-05-12,KY,6677,97347,104024,21,Kentucky
2020-05-12,LA,32050,195962,228012,22,Louisiana
2020-05-12,MA,79332,322164,401496,25,Massachusetts
2020-05-12,MD,34061,135442,169503,24,Maryland
2020-05-12,ME,1477,22092,23569,23,Maine
2020-05-12,MI,55641,291701,347342,26,Michigan
2020-05-12,MN,15043,118934,133977,27,Minnesota
2020-05-12,MO,10006,111290,121296,29,Missouri
2020-05-12,MP,19,2854,2873,69,Northern Mariana Islands
2020-05-12,MS,9908,87784,97692,28,Mississippi
2020-05-12,MT,461,22574,23035,30,Montana
2020-05-12,NC,15346,186898,202244,37,North Carolina
2020-05-12,ND,1571,46261,47832,38,North Dakota
2020-05-12,NE,8572,39371,47943,31,Nebraska
2020-05-12,NH,3160,32401,35561,33,New Hampshire
2020-05-12,NJ,140743,292317,433060,34,New Jersey
2020-05-12,NM,5069,101652,106721,35,New Mexico
2020-05-12,NV,6311,57764,64075,32,Nevada
2020-05-12,NY,338485,886628,1225113,36,New York
2020-05-12,OH,25250,192481,217731,39,Ohio
2020-05-12,OK,4732,91379,96111,40,Oklahoma
2020-05-12,OR,3286,74320,77606,41,Oregon
2020-05-12,PA,57991,237989,295980,42,Pennsylvania
2020-05-12,PR,2299,NA,2299,72,Puerto Rico
2020-05-12,RI,12007,70916,82923,44,Rhode Island
2020-05-12,SC,7927,85213,93140,45,South Carolina
2020-05-12,SD,3663,21534,25197,46,South Dakota
2020-05-12,TN,16111,267713,283824,47,Tennessee
2020-05-12,TX,41048,497124,538172,48,Texas
2020-05-12,UT,6432,147053,153485,49,Utah
2020-05-12,VA,25800,129529,155329,51,Virginia
2020-05-12,VI,69,1115,1184,78,U.S. Virgin Islands
2020-05-12,VT,929,19107,20036,50,Vermont
2020-05-12,WA,18952,233864,252816,53,Washington
2020-05-12,WI,12131,112748,124879,55,Wisconsin
2020-05-12,WV,1371,63698,65069,54,West Virginia
2020-05-12,WY,675,14384,15059,56,Wyoming
2020-05-11,AK,381,28299,28680,02,Alaska
2020-05-11,AL,10009,119435,129444,01,Alabama
2020-05-11,AR,4034,64996,69030,05,Arkansas
2020-05-11,AS,0,105,105,60,American Samoa
2020-05-11,AZ,11380,105084,116464,04,Arizona
2020-05-11,CA,67939,923958,991897,06,California
2020-05-11,CO,19899,88891,108790,08,Colorado
2020-05-11,CT,33765,98743,132508,09,Connecticut
2020-05-11,DC,6389,23872,30261,11,District of Columbia
2020-05-11,DE,6565,25363,31928,10,Delaware
2020-05-11,FL,40982,520075,561057,12,Florida
2020-05-11,GA,33927,217361,251288,13,Georgia
2020-05-11,GU,151,3838,3989,66,Guam
2020-05-11,HI,632,37051,37683,15,Hawaii
2020-05-11,IA,12373,65419,77792,19,Iowa
2020-05-11,ID,2230,29912,32142,16,Idaho
2020-05-11,IL,79007,363418,442425,17,Illinois
2020-05-11,IN,24627,122061,146688,18,Indiana
2020-05-11,KS,7116,46993,54109,20,Kansas
2020-05-11,KY,6440,80483,86923,21,Kentucky
2020-05-11,LA,31815,189015,220830,22,Louisiana
2020-05-11,MA,78462,316266,394728,25,Massachusetts
2020-05-11,MD,33373,131407,164780,24,Maryland
2020-05-11,ME,1462,22092,23554,23,Maine
2020-05-11,MI,54004,278293,332297,26,Michigan
2020-05-11,MN,14379,115585,129964,27,Minnesota
2020-05-11,MO,9918,105702,115620,29,Missouri
2020-05-11,MP,19,2676,2695,69,Northern Mariana Islands
2020-05-11,MS,9674,86211,95885,28,Mississippi
2020-05-11,MT,459,22113,22572,30,Montana
2020-05-11,NC,15045,180820,195865,37,North Carolina
2020-05-11,ND,1518,45496,47014,38,North Dakota
2020-05-11,NE,8315,37924,46239,31,Nebraska
2020-05-11,NH,3160,31723,34883,33,New Hampshire
2020-05-11,NJ,139945,285988,425933,34,New Jersey
2020-05-11,NM,4863,97635,102498,35,New Mexico
2020-05-11,NV,6152,53932,60084,32,Nevada
2020-05-11,NY,337055,867596,1204651,36,New York
2020-05-11,OH,24777,185753,210530,39,Ohio
2020-05-11,OK,4613,91379,95992,40,Oklahoma
2020-05-11,OR,3286,74320,77606,41,Oregon
2020-05-11,PA,57154,231704,288858,42,Pennsylvania
2020-05-11,PR,2256,NA,2256,72,Puerto Rico
2020-05-11,RI,11788,69365,81153,44,Rhode Island
2020-05-11,SC,7653,76804,84457,45,South Carolina
2020-05-11,SD,3614,20964,24578,46,South Dakota
2020-05-11,TN,15544,257733,273277,47,Tennessee
2020-05-11,TX,39869,485828,525697,48,Texas
2020-05-11,UT,6362,144223,150585,49,Utah
2020-05-11,VA,25070,125547,150617,51,Virginia
2020-05-11,VI,69,1110,1179,78,U.S. Virgin Islands
2020-05-11,VT,927,18797,19724,50,Vermont
2020-05-11,WA,18741,229099,247840,53,Washington
2020-05-11,WI,11920,108033,119953,55,Wisconsin
2020-05-11,WV,1366,62103,63469,54,West Virginia
2020-05-11,WY,662,11403,12065,56,Wyoming
2020-05-10,AK,379,26985,27364,02,Alaska
2020-05-10,AL,9777,117644,127421,01,Alabama
2020-05-10,AR,3747,61781,65528,05,Arkansas
2020-05-10,AS,0,83,83,60,American Samoa
2020-05-10,AZ,11119,99258,110377,04,Arizona
2020-05-10,CA,66680,888984,955664,06,California
2020-05-10,CO,19703,84374,104077,08,Colorado
2020-05-10,CT,33554,96638,130192,09,Connecticut
2020-05-10,DC,6272,23298,29570,11,District of Columbia
2020-05-10,DE,6447,24592,31039,10,Delaware
2020-05-10,FL,40596,498352,538948,12,Florida
2020-05-10,GA,33441,210106,243547,13,Georgia
2020-05-10,GU,151,3643,3794,66,Guam
2020-05-10,HI,631,36639,37270,15,Hawaii
2020-05-10,IA,11959,62215,74174,19,Iowa
2020-05-10,ID,2230,29912,32142,16,Idaho
2020-05-10,IL,77741,352243,429984,17,Illinois
2020-05-10,IN,24126,115903,140029,18,Indiana
2020-05-10,KS,6948,45557,52505,20,Kansas
2020-05-10,KY,6440,80483,86923,21,Kentucky
2020-05-10,LA,31600,184272,215872,22,Louisiana
2020-05-10,MA,77793,310596,388389,25,Massachusetts
2020-05-10,MD,32587,127344,159931,24,Maryland
2020-05-10,ME,1436,22092,23528,23,Maine
2020-05-10,MI,53033,267417,320450,26,Michigan
2020-05-10,MN,13552,111109,124661,27,Minnesota
2020-05-10,MO,9844,105702,115546,29,Missouri
2020-05-10,MP,16,2321,2337,69,Northern Mariana Islands
2020-05-10,MS,9501,72101,81602,28,Mississippi
2020-05-10,MT,458,21246,21704,30,Montana
2020-05-10,NC,14764,177371,192135,37,North Carolina
2020-05-10,ND,1491,43378,44869,38,North Dakota
2020-05-10,NE,8234,37335,45569,31,Nebraska
2020-05-10,NH,3011,30442,33453,33,New Hampshire
2020-05-10,NJ,138532,173915,312447,34,New Jersey
2020-05-10,NM,4778,92275,97053,35,New Mexico
2020-05-10,NV,6098,52711,58809,32,Nevada
2020-05-10,NY,335395,847603,1182998,36,New York
2020-05-10,OH,24081,180781,204862,39,Ohio
2020-05-10,OK,4589,91379,95968,40,Oklahoma
2020-05-10,OR,3228,72279,75507,41,Oregon
2020-05-10,PA,56611,227772,284383,42,Pennsylvania
2020-05-10,PR,2198,NA,2198,72,Puerto Rico
2020-05-10,RI,11613,68106,79719,44,Rhode Island
2020-05-10,SC,7653,76804,84457,45,South Carolina
2020-05-10,SD,3517,20377,23894,46,South Dakota
2020-05-10,TN,14985,246884,261869,47,Tennessee
2020-05-10,TX,38869,462907,501776,48,Texas
2020-05-10,UT,6251,140259,146510,49,Utah
2020-05-10,VA,24081,118974,143055,51,Virginia
2020-05-10,VI,69,1102,1171,78,U.S. Virgin Islands
2020-05-10,VT,926,18167,19093,50,Vermont
2020-05-10,WA,18449,224548,242997,53,Washington
2020-05-10,WI,11694,105163,116857,55,Wisconsin
2020-05-10,WV,1360,61284,62644,54,West Virginia
2020-05-10,WY,661,11403,12064,56,Wyoming
2020-05-09,AK,378,26071,26449,02,Alaska
2020-05-09,AL,9567,115927,125494,01,Alabama
2020-05-09,AR,3747,61781,65528,05,Arkansas
2020-05-09,AS,0,83,83,60,American Samoa
2020-05-09,AZ,10960,94850,105810,04,Arizona
2020-05-09,CA,64561,848009,912570,06,California
2020-05-09,CO,18827,77945,96772,08,Colorado
2020-05-09,CT,32984,90585,123569,09,Connecticut
2020-05-09,DC,6102,22081,28183,11,District of Columbia
2020-05-09,DE,6277,23019,29296,10,Delaware
2020-05-09,FL,40001,487730,527731,12,Florida
2020-05-09,GA,32532,202792,235324,13,Georgia
2020-05-09,GU,151,3643,3794,66,Guam
2020-05-09,HI,629,35633,36262,15,Hawaii
2020-05-09,IA,11671,59805,71476,19,Iowa
2020-05-09,ID,2205,29601,31806,16,Idaho
2020-05-09,IL,76085,340246,416331,17,Illinois
2020-05-09,IN,23732,111954,135686,18,Indiana
2020-05-09,KS,6751,43182,49933,20,Kansas
2020-05-09,KY,6288,80159,86447,21,Kentucky
2020-05-09,LA,31417,180740,212157,22,Louisiana
2020-05-09,MA,76743,299794,376537,25,Massachusetts
2020-05-09,MD,31534,124494,156028,24,Maryland
2020-05-09,ME,1408,22092,23500,23,Maine
2020-05-09,MI,52732,259265,311997,26,Michigan
2020-05-09,MN,13321,106040,119361,27,Minnesota
2020-05-09,MO,9666,99232,108898,29,Missouri
2020-05-09,MP,16,2321,2337,69,Northern Mariana Islands
2020-05-09,MS,9378,72101,81479,28,Mississippi
2020-05-09,MT,458,20871,21329,30,Montana
2020-05-09,NC,14360,172002,186362,37,North Carolina
2020-05-09,ND,1464,42469,43933,38,North Dakota
2020-05-09,NE,7831,35145,42976,31,Nebraska
2020-05-09,NH,2947,29351,32298,33,New Hampshire
2020-05-09,NJ,137085,168121,305206,34,New Jersey
2020-05-09,NM,4673,88589,93262,35,New Mexico
2020-05-09,NV,6028,50083,56111,32,Nevada
2020-05-09,NY,333122,820646,1153768,36,New York
2020-05-09,OH,23697,172973,196670,39,Ohio
2020-05-09,OK,4490,91379,95869,40,Oklahoma
2020-05-09,OR,3160,71460,74620,41,Oregon
2020-05-09,PA,55316,221791,277107,42,Pennsylvania
2020-05-09,PR,2173,NA,2173,72,Puerto Rico
2020-05-09,RI,11427,66604,78031,44,Rhode Island
2020-05-09,SC,7531,73432,80963,45,South Carolina
2020-05-09,SD,3393,19559,22952,46,South Dakota
2020-05-09,TN,14768,237980,252748,47,Tennessee
2020-05-09,TX,37860,451434,489294,48,Texas
2020-05-09,UT,6103,137191,143294,49,Utah
2020-05-09,VA,23196,113953,137149,51,Virginia
2020-05-09,VI,68,1024,1092,78,U.S. Virgin Islands
2020-05-09,VT,926,17690,18616,50,Vermont
2020-05-09,WA,18275,223361,241636,53,Washington
2020-05-09,WI,11402,101935,113337,55,Wisconsin
2020-05-09,WV,1335,59662,60997,54,West Virginia
2020-05-09,WY,644,11403,12047,56,Wyoming
2020-05-08,AK,377,25096,25473,02,Alaska
2020-05-08,AL,9221,110893,120114,01,Alabama
2020-05-08,AR,3694,60300,63994,05,Arkansas
2020-05-08,AS,0,83,83,60,American Samoa
2020-05-08,AZ,10526,90599,101125,04,Arizona
2020-05-08,CA,62512,812760,875272,06,California
2020-05-08,CO,18801,75735,94536,08,Colorado
2020-05-08,CT,32411,88130,120541,09,Connecticut
2020-05-08,DC,5899,21216,27115,11,District of Columbia
2020-05-08,DE,6111,22153,28264,10,Delaware
2020-05-08,FL,39199,474142,513341,12,Florida
2020-05-08,GA,32106,195461,227567,13,Georgia
2020-05-08,GU,151,3626,3777,66,Guam
2020-05-08,HI,629,35989,36618,15,Hawaii
2020-05-08,IA,11457,58804,70261,19,Iowa
2020-05-08,ID,2178,29092,31270,16,Idaho
2020-05-08,IL,73760,325954,399714,17,Illinois
2020-05-08,IN,23146,106982,130128,18,Indiana
2020-05-08,KS,6501,41207,47708,20,Kansas
2020-05-08,KY,6129,75272,81401,21,Kentucky
2020-05-08,LA,30855,171561,202416,22,Louisiana
2020-05-08,MA,75333,290690,366023,25,Massachusetts
2020-05-08,MD,30485,121702,152187,24,Maryland
2020-05-08,ME,1374,22092,23466,23,Maine
2020-05-08,MI,52349,248142,300491,26,Michigan
2020-05-08,MN,13040,101408,114448,27,Minnesota
2020-05-08,MO,9489,99232,108721,29,Missouri
2020-05-08,MP,15,2321,2336,69,Northern Mariana Islands
2020-05-08,MS,9090,72101,81191,28,Mississippi
2020-05-08,MT,458,20487,20945,30,Montana
2020-05-08,NC,13868,164745,178613,37,North Carolina
2020-05-08,ND,1425,41076,42501,38,North Dakota
2020-05-08,NE,7190,33222,40412,31,Nebraska
2020-05-08,NH,2843,27829,30672,33,New Hampshire
2020-05-08,NJ,135454,163305,298759,34,New Jersey
2020-05-08,NM,4493,84539,89032,35,New Mexico
2020-05-08,NV,5884,47460,53344,32,Nevada
2020-05-08,NY,330407,791136,1121543,36,New York
2020-05-08,OH,23016,161300,184316,39,Ohio
2020-05-08,OK,4424,85433,89857,40,Oklahoma
2020-05-08,OR,3068,69625,72693,41,Oregon
2020-05-08,PA,54238,216321,270559,42,Pennsylvania
2020-05-08,PR,2156,NA,2156,72,Puerto Rico
2020-05-08,RI,11141,64338,75479,44,Rhode Island
2020-05-08,SC,7142,66300,73442,45,South Carolina
2020-05-08,SD,3144,18149,21293,46,South Dakota
2020-05-08,TN,14441,229137,243578,47,Tennessee
2020-05-08,TX,36609,440509,477118,48,Texas
2020-05-08,UT,5919,132769,138688,49,Utah
2020-05-08,VA,22342,107603,129945,51,Virginia
2020-05-08,VI,68,1024,1092,78,U.S. Virgin Islands
2020-05-08,VT,918,17222,18140,50,Vermont
2020-05-08,WA,18124,221418,239542,53,Washington
2020-05-08,WI,11030,97265,108295,55,Wisconsin
2020-05-08,WV,1310,58126,59436,54,West Virginia
2020-05-08,WY,635,11403,12038,56,Wyoming
2020-05-07,AK,374,23967,24341,02,Alaska
2020-05-07,AL,8898,106275,115173,01,Alabama
2020-05-07,AR,3611,56384,59995,05,Arkansas
2020-05-07,AS,0,83,83,60,American Samoa
2020-05-07,AZ,9945,86489,96434,04,Arizona
2020-05-07,CA,60614,782260,842874,06,California
2020-05-07,CO,17830,73517,91347,08,Colorado
2020-05-07,CT,31784,84390,116174,09,Connecticut
2020-05-07,DC,5654,20202,25856,11,District of Columbia
2020-05-07,DE,5939,21387,27326,10,Delaware
2020-05-07,FL,38828,454122,492950,12,Florida
2020-05-07,GA,31439,185864,217303,13,Georgia
2020-05-07,GU,151,3564,3715,66,Guam
2020-05-07,HI,626,34915,35541,15,Hawaii
2020-05-07,IA,11059,55368,66427,19,Iowa
2020-05-07,ID,2158,28732,30890,16,Idaho
2020-05-07,IL,70873,308170,379043,17,Illinois
2020-05-07,IN,22503,102279,124782,18,Indiana
2020-05-07,KS,6144,38678,44822,20,Kansas
2020-05-07,KY,5934,72672,78606,21,Kentucky
2020-05-07,LA,30652,170115,200767,22,Louisiana
2020-05-07,MA,73721,277911,351632,25,Massachusetts
2020-05-07,MD,29374,119226,148600,24,Maryland
2020-05-07,ME,1330,22092,23422,23,Maine
2020-05-07,MI,51731,236184,287915,26,Michigan
2020-05-07,MN,12328,97244,109572,27,Minnesota
2020-05-07,MO,9341,94281,103622,29,Missouri
2020-05-07,MP,15,1783,1798,69,Northern Mariana Islands
2020-05-07,MS,8686,72101,80787,28,Mississippi
2020-05-07,MT,456,19791,20247,30,Montana
2020-05-07,NC,13397,157931,171328,37,North Carolina
2020-05-07,ND,1371,39496,40867,38,North Dakota
2020-05-07,NE,6771,30987,37758,31,Nebraska
2020-05-07,NH,2740,26066,28806,33,New Hampshire
2020-05-07,NJ,133635,159023,292658,34,New Jersey
2020-05-07,NM,4291,81393,85684,35,New Mexico
2020-05-07,NV,5766,45591,51357,32,Nevada
2020-05-07,NY,327649,762267,1089916,36,New York
2020-05-07,OH,22131,153928,176059,39,Ohio
2020-05-07,OK,4330,82557,86887,40,Oklahoma
2020-05-07,OR,2989,67469,70458,41,Oregon
2020-05-07,PA,52915,209873,262788,42,Pennsylvania
2020-05-07,PR,2031,NA,2031,72,Puerto Rico
2020-05-07,RI,10910,62647,73557,44,Rhode Island
2020-05-07,SC,6936,70546,77482,45,South Carolina
2020-05-07,SD,2905,17209,20114,46,South Dakota
2020-05-07,TN,14096,222232,236328,47,Tennessee
2020-05-07,TX,35390,419772,455162,48,Texas
2020-05-07,UT,5724,128819,134543,49,Utah
2020-05-07,VA,21570,101582,123152,51,Virginia
2020-05-07,VI,66,990,1056,78,U.S. Virgin Islands
2020-05-07,VT,916,16690,17606,50,Vermont
2020-05-07,WA,17914,216453,234367,53,Washington
2020-05-07,WI,10621,93035,103656,55,Wisconsin
2020-05-07,WV,1287,56234,57521,54,West Virginia
2020-05-07,WY,631,11403,12034,56,Wyoming
2020-05-06,AK,372,23283,23655,02,Alaska
2020-05-06,AL,8581,100935,109516,01,Alabama
2020-05-06,AR,3568,55435,59003,05,Arkansas
2020-05-06,AS,0,83,83,60,American Samoa
2020-05-06,AZ,9707,82030,91737,04,Arizona
2020-05-06,CA,58815,750221,809036,06,California
2020-05-06,CO,17364,68612,85976,08,Colorado
2020-05-06,CT,30995,80452,111447,09,Connecticut
2020-05-06,DC,5461,19523,24984,11,District of Columbia
2020-05-06,DE,5778,20690,26468,10,Delaware
2020-05-06,FL,38002,442049,480051,12,Florida
2020-05-06,GA,30696,173441,204137,13,Georgia
2020-05-06,GU,151,3476,3627,66,Guam
2020-05-06,HI,625,34574,35199,15,Hawaii
2020-05-06,IA,10404,52767,63171,19,Iowa
2020-05-06,ID,2127,28418,30545,16,Idaho
2020-05-06,IL,68232,293028,361260,17,Illinois
2020-05-06,IN,21870,98626,120496,18,Indiana
2020-05-06,KS,5734,36380,42114,20,Kansas
2020-05-06,KY,5822,55192,61014,21,Kentucky
2020-05-06,LA,30399,164273,194672,22,Louisiana
2020-05-06,MA,72025,267614,339639,25,Massachusetts
2020-05-06,MD,28163,115849,144012,24,Maryland
2020-05-06,ME,1254,22092,23346,23,Maine
2020-05-06,MI,51131,224563,275694,26,Michigan
2020-05-06,MN,11510,93047,104557,27,Minnesota
2020-05-06,MO,9102,91645,100747,29,Missouri
2020-05-06,MP,15,1783,1798,69,Northern Mariana Islands
2020-05-06,MS,8424,72101,80525,28,Mississippi
2020-05-06,MT,456,19248,19704,30,Montana
2020-05-06,NC,12758,151724,164482,37,North Carolina
2020-05-06,ND,1323,37309,38632,38,North Dakota
2020-05-06,NE,6438,29690,36128,31,Nebraska
2020-05-06,NH,2636,25097,27733,33,New Hampshire
2020-05-06,NJ,131890,157030,288920,34,New Jersey
2020-05-06,NM,4138,79113,83251,35,New Mexico
2020-05-06,NV,5663,43612,49275,32,Nevada
2020-05-06,NY,323978,731943,1055921,36,New York
2020-05-06,OH,21576,147353,168929,39,Ohio
2020-05-06,OK,4201,78689,82890,40,Oklahoma
2020-05-06,OR,2916,65060,67976,41,Oregon
2020-05-06,PA,51845,204495,256340,42,Pennsylvania
2020-05-06,PR,1968,NA,1968,72,Puerto Rico
2020-05-06,RI,10639,60718,71357,44,Rhode Island
2020-05-06,SC,6936,70546,77482,45,South Carolina
2020-05-06,SD,2779,16637,19416,46,South Dakota
2020-05-06,TN,13938,213163,227101,47,Tennessee
2020-05-06,TX,34422,404516,438938,48,Texas
2020-05-06,UT,5595,125407,131002,49,Utah
2020-05-06,VA,20256,93452,113708,51,Virginia
2020-05-06,VI,66,990,1056,78,U.S. Virgin Islands
2020-05-06,VT,914,16281,17195,50,Vermont
2020-05-06,WA,17718,212065,229783,53,Washington
2020-05-06,WI,10262,87826,98088,55,Wisconsin
2020-05-06,WV,1248,54536,55784,54,West Virginia
2020-05-06,WY,604,11403,12007,56,Wyoming
2020-05-05,AK,371,22321,22692,02,Alaska
2020-05-05,AL,8285,98481,106766,01,Alabama
2020-05-05,AR,3496,51139,54635,05,Arkansas
2020-05-05,AS,0,83,83,60,American Samoa
2020-05-05,AZ,9305,78955,88260,04,Arizona
2020-05-05,CA,56212,723690,779902,06,California
2020-05-05,CO,16907,68097,85004,08,Colorado
2020-05-05,CT,30621,78022,108643,09,Connecticut
2020-05-05,DC,5322,19007,24329,11,District of Columbia
2020-05-05,DE,5371,19309,24680,10,Delaware
2020-05-05,FL,37439,428252,465691,12,Florida
2020-05-05,GA,29711,171172,200883,13,Georgia
2020-05-05,GU,149,3341,3490,66,Guam
2020-05-05,HI,621,33378,33999,15,Hawaii
2020-05-05,IA,10111,50458,60569,19,Iowa
2020-05-05,ID,2106,28202,30308,16,Idaho
2020-05-05,IL,65962,280324,346286,17,Illinois
2020-05-05,IN,21033,94801,115834,18,Indiana
2020-05-05,KS,5458,34634,40092,20,Kansas
2020-05-05,KY,5245,54802,60047,21,Kentucky
2020-05-05,LA,29996,158235,188231,22,Louisiana
2020-05-05,MA,70271,263078,333349,25,Massachusetts
2020-05-05,MD,27117,112986,140103,24,Maryland
2020-05-05,ME,1226,19546,20772,23,Maine
2020-05-05,MI,50497,213091,263588,26,Michigan
2020-05-05,MN,10876,89202,100078,27,Minnesota
2020-05-05,MO,8916,86150,95066,29,Missouri
2020-05-05,MP,14,1783,1797,69,Northern Mariana Islands
2020-05-05,MS,8207,72101,80308,28,Mississippi
2020-05-05,MT,456,14816,15272,30,Montana
2020-05-05,NC,12256,139544,151800,37,North Carolina
2020-05-05,ND,1266,35155,36421,38,North Dakota
2020-05-05,NE,6083,28526,34609,31,Nebraska
2020-05-05,NH,2588,24282,26870,33,New Hampshire
2020-05-05,NJ,130593,157030,287623,34,New Jersey
2020-05-05,NM,4031,77689,81720,35,New Mexico
2020-05-05,NV,5594,42290,47884,32,Nevada
2020-05-05,NY,321192,707707,1028899,36,New York
2020-05-05,OH,20969,139766,160735,39,Ohio
2020-05-05,OK,4127,75290,79417,40,Oklahoma
2020-05-05,OR,2839,62585,65424,41,Oregon
2020-05-05,PA,50957,199925,250882,42,Pennsylvania
2020-05-05,PR,1924,9313,11237,72,Puerto Rico
2020-05-05,RI,10297,58781,69078,44,Rhode Island
2020-05-05,SC,6757,61014,67771,45,South Carolina
2020-05-05,SD,2721,16301,19022,46,South Dakota
2020-05-05,TN,13690,205172,218862,47,Tennessee
2020-05-05,TX,33369,393841,427210,48,Texas
2020-05-05,UT,5449,121266,126715,49,Utah
2020-05-05,VA,20256,93452,113708,51,Virginia
2020-05-05,VI,66,973,1039,78,U.S. Virgin Islands
2020-05-05,VT,909,16065,16974,50,Vermont
2020-05-05,WA,17470,207014,224484,53,Washington
2020-05-05,WI,9896,83967,93863,55,Wisconsin
2020-05-05,WV,1238,53585,54823,54,West Virginia
2020-05-05,WY,596,10319,10915,56,Wyoming
2020-05-04,AK,370,21353,21723,02,Alaska
2020-05-04,AL,8025,95092,103117,01,Alabama
2020-05-04,AR,3458,50984,54442,05,Arkansas
2020-05-04,AS,0,83,83,60,American Samoa
2020-05-04,AZ,8919,76334,85253,04,Arizona
2020-05-04,CA,54937,692937,747874,06,California
2020-05-04,CO,16635,66455,83090,08,Colorado
2020-05-04,CT,29287,73206,102493,09,Connecticut
2020-05-04,DC,5170,18625,23795,11,District of Columbia
2020-05-04,DE,5288,18822,24110,10,Delaware
2020-05-04,FL,36897,407373,444270,12,Florida
2020-05-04,GA,29368,153957,183325,13,Georgia
2020-05-04,GU,149,3242,3391,66,Guam
2020-05-04,HI,620,33246,33866,15,Hawaii
2020-05-04,IA,9703,47458,57161,19,Iowa
2020-05-04,ID,2061,27746,29807,16,Idaho
2020-05-04,IL,63840,269307,333147,17,Illinois
2020-05-04,IN,20507,92790,113297,18,Indiana
2020-05-04,KS,5245,33358,38603,20,Kansas
2020-05-04,KY,5130,53279,58409,21,Kentucky
2020-05-04,LA,29673,151258,180931,22,Louisiana
2020-05-04,MA,69087,255181,324268,25,Massachusetts
2020-05-04,MD,26408,110587,136995,24,Maryland
2020-05-04,ME,1205,19546,20751,23,Maine
2020-05-04,MI,49809,202671,252480,26,Michigan
2020-05-04,MN,10235,86677,96912,27,Minnesota
2020-05-04,MO,8754,82697,91451,29,Missouri
2020-05-04,MP,14,1321,1335,69,Northern Mariana Islands
2020-05-04,MS,7877,71800,79677,28,Mississippi
2020-05-04,MT,457,14631,15088,30,Montana
2020-05-04,NC,11848,134591,146439,37,North Carolina
2020-05-04,ND,1225,33529,34754,38,North Dakota
2020-05-04,NE,5910,27844,33754,31,Nebraska
2020-05-04,NH,2588,24282,26870,33,New Hampshire
2020-05-04,NJ,128269,148951,277220,34,New Jersey
2020-05-04,NM,3850,74127,77977,35,New Mexico
2020-05-04,NV,5491,40675,46166,32,Nevada
2020-05-04,NY,318953,688357,1007310,36,New York
2020-05-04,OH,20474,134681,155155,39,Ohio
2020-05-04,OK,4044,59804,63848,40,Oklahoma
2020-05-04,OR,2759,60698,63457,41,Oregon
2020-05-04,PA,50092,195498,245590,42,Pennsylvania
2020-05-04,PR,1843,9313,11156,72,Puerto Rico
2020-05-04,RI,9994,56802,66796,44,Rhode Island
2020-05-04,SC,6626,57562,64188,45,South Carolina
2020-05-04,SD,2668,16045,18713,46,South Dakota
2020-05-04,TN,13571,197872,211443,47,Tennessee
2020-05-04,TX,32332,375066,407398,48,Texas
2020-05-04,UT,5317,119344,124661,49,Utah
2020-05-04,VA,19492,92801,112293,51,Virginia
2020-05-04,VI,66,965,1031,78,U.S. Virgin Islands
2020-05-04,VT,906,15889,16795,50,Vermont
2020-05-04,WA,17209,202206,219415,53,Washington
2020-05-04,WI,9538,80467,90005,55,Wisconsin
2020-05-04,WV,1206,52033,53239,54,West Virginia
2020-05-04,WY,586,9868,10454,56,Wyoming
2020-05-03,AK,368,21210,21578,02,Alaska
2020-05-03,AL,7725,84775,92500,01,Alabama
2020-05-03,AR,3431,49459,52890,05,Arkansas
2020-05-03,AS,0,57,57,60,American Samoa
2020-05-03,AZ,8640,72479,81119,04,Arizona
2020-05-03,CA,53616,662135,715751,06,California
2020-05-03,CO,16225,63681,79906,08,Colorado
2020-05-03,CT,29287,73206,102493,09,Connecticut
2020-05-03,DC,5016,18086,23102,11,District of Columbia
2020-05-03,DE,5208,18529,23737,10,Delaware
2020-05-03,FL,36078,392111,428189,12,Florida
2020-05-03,GA,28602,146494,175096,13,Georgia
2020-05-03,GU,150,3152,3302,66,Guam
2020-05-03,HI,620,32330,32950,15,Hawaii
2020-05-03,IA,9169,44017,53186,19,Iowa
2020-05-03,ID,2061,27746,29807,16,Idaho
2020-05-03,IL,61499,257814,319313,17,Illinois
2020-05-03,IN,19933,88926,108859,18,Indiana
2020-05-03,KS,5030,31748,36778,20,Kansas
2020-05-03,KY,4879,52770,57649,21,Kentucky
2020-05-03,LA,29340,146820,176160,22,Louisiana
2020-05-03,MA,68087,246559,314646,25,Massachusetts
2020-05-03,MD,25462,107332,132794,24,Maryland
2020-05-03,ME,1185,19546,20731,23,Maine
2020-05-03,MI,49029,195361,244390,26,Michigan
2020-05-03,MN,9411,83433,92844,27,Minnesota
2020-05-03,MO,8386,74590,82976,29,Missouri
2020-05-03,MP,14,1321,1335,69,Northern Mariana Islands
2020-05-03,MS,7550,70043,77593,28,Mississippi
2020-05-03,MT,455,14552,15007,30,Montana
2020-05-03,NC,11664,132171,143835,37,North Carolina
2020-05-03,ND,1191,32162,33353,38,North Dakota
2020-05-03,NE,5326,25936,31262,31,Nebraska
2020-05-03,NH,2429,25964,28393,33,New Hampshire
2020-05-03,NJ,126744,148322,275066,34,New Jersey
2020-05-03,NM,3732,71212,74944,35,New Mexico
2020-05-03,NV,5426,39843,45269,32,Nevada
2020-05-03,NY,316415,669496,985911,36,New York
2020-05-03,OH,19914,130252,150166,39,Ohio
2020-05-03,OK,3972,59804,63776,40,Oklahoma
2020-05-03,OR,2680,59374,62054,41,Oregon
2020-05-03,PA,49267,191374,240641,42,Pennsylvania
2020-05-03,PR,1808,9313,11121,72,Puerto Rico
2020-05-03,RI,9703,55233,64936,44,Rhode Island
2020-05-03,SC,6626,57562,64188,45,South Carolina
2020-05-03,SD,2631,15786,18417,46,South Dakota
2020-05-03,TN,13177,191430,204607,47,Tennessee
2020-05-03,TX,31548,359012,390560,48,Texas
2020-05-03,UT,5175,116927,122102,49,Utah
2020-05-03,VA,18671,89331,108002,51,Virginia
2020-05-03,VI,66,951,1017,78,U.S. Virgin Islands
2020-05-03,VT,901,15570,16471,50,Vermont
2020-05-03,WA,16943,196962,213905,53,Washington
2020-05-03,WI,9227,77997,87224,55,Wisconsin
2020-05-03,WV,1191,50447,51638,54,West Virginia
2020-05-03,WY,579,9640,10219,56,Wyoming
2020-05-02,AK,365,21034,21399,02,Alaska
2020-05-02,AL,7434,84775,92209,01,Alabama
2020-05-02,AR,3372,48210,51582,05,Arkansas
2020-05-02,AS,0,57,57,60,American Samoa
2020-05-02,AZ,8364,69633,77997,04,Arizona
2020-05-02,CA,52197,634606,686803,06,California
2020-05-02,CO,15768,61181,76949,08,Colorado
2020-05-02,CT,28764,71493,100257,09,Connecticut
2020-05-02,DC,4797,17207,22004,11,District of Columbia
2020-05-02,DE,5038,18074,23112,10,Delaware
2020-05-02,FL,35463,380549,416012,12,Florida
2020-05-02,GA,28306,146494,174800,13,Georgia
2020-05-02,GU,148,3040,3188,66,Guam
2020-05-02,HI,619,31366,31985,15,Hawaii
2020-05-02,IA,8641,37708,46349,19,Iowa
2020-05-02,ID,2035,27455,29490,16,Idaho
2020-05-02,IL,58505,241391,299896,17,Illinois
2020-05-02,IN,19295,84846,104141,18,Indiana
2020-05-02,KS,4746,30196,34942,20,Kansas
2020-05-02,KY,4879,52770,57649,21,Kentucky
2020-05-02,LA,29140,143718,172858,22,Louisiana
2020-05-02,MA,66263,232731,298994,25,Massachusetts
2020-05-02,MD,24473,101049,125522,24,Maryland
2020-05-02,ME,1152,19546,20698,23,Maine
2020-05-02,MI,48672,188713,237385,26,Michigan
2020-05-02,MN,9071,80609,89680,27,Minnesota
2020-05-02,MO,8154,74590,82744,29,Missouri
2020-05-02,MP,14,934,948,69,Northern Mariana Islands
2020-05-02,MS,7441,67034,74475,28,Mississippi
2020-05-02,MT,455,14180,14635,30,Montana
2020-05-02,NC,11509,127966,139475,37,North Carolina
2020-05-02,ND,1153,30394,31547,38,North Dakota
2020-05-02,NE,4838,24510,29348,31,Nebraska
2020-05-02,NH,2310,22039,24349,33,New Hampshire
2020-05-02,NJ,123717,138595,262312,34,New Jersey
2020-05-02,NM,3513,67605,71118,35,New Mexico
2020-05-02,NV,5311,39076,44387,32,Nevada
2020-05-02,NY,312977,646094,959071,36,New York
2020-05-02,OH,19335,126484,145819,39,Ohio
2020-05-02,OK,3851,59804,63655,40,Oklahoma
2020-05-02,OR,2635,57501,60136,41,Oregon
2020-05-02,PA,48305,187071,235376,42,Pennsylvania
2020-05-02,PR,1757,9313,11070,72,Puerto Rico
2020-05-02,RI,9522,53623,63145,44,Rhode Island
2020-05-02,SC,6489,55127,61616,45,South Carolina
2020-05-02,SD,2588,15503,18091,46,South Dakota
2020-05-02,TN,12661,183615,196276,47,Tennessee
2020-05-02,TX,30522,350126,380648,48,Texas
2020-05-02,UT,4981,112823,117804,49,Utah
2020-05-02,VA,17731,84365,102096,51,Virginia
2020-05-02,VI,66,922,988,78,U.S. Virgin Islands
2020-05-02,VT,896,15232,16128,50,Vermont
2020-05-02,WA,16802,195619,212421,53,Washington
2020-05-02,WI,8920,75570,84490,55,Wisconsin
2020-05-02,WV,1169,47977,49146,54,West Virginia
2020-05-02,WY,566,9463,10029,56,Wyoming
2020-05-01,AK,364,19961,20325,02,Alaska
2020-05-01,AL,7158,84775,91933,01,Alabama
2020-05-01,AR,3321,46355,49676,05,Arkansas
2020-05-01,AS,0,57,57,60,American Samoa
2020-05-01,AZ,7962,66917,74879,04,Arizona
2020-05-01,CA,50442,604543,654985,06,California
2020-05-01,CO,15284,57106,72390,08,Colorado
2020-05-01,CT,28764,71493,100257,09,Connecticut
2020-05-01,DC,4658,16477,21135,11,District of Columbia
2020-05-01,DE,4918,17667,22585,10,Delaware
2020-05-01,FL,34728,367971,402699,12,Florida
2020-05-01,GA,27270,141097,168367,13,Georgia
2020-05-01,GU,146,2859,3005,66,Guam
2020-05-01,HI,618,30476,31094,15,Hawaii
2020-05-01,IA,7884,37708,45592,19,Iowa
2020-05-01,ID,2015,27210,29225,16,Idaho
2020-05-01,IL,56055,228633,284688,17,Illinois
2020-05-01,IN,18630,81009,99639,18,Indiana
2020-05-01,KS,4449,28585,33034,20,Kansas
2020-05-01,KY,4708,51904,56612,21,Kentucky
2020-05-01,LA,28711,139540,168251,22,Louisiana
2020-05-01,MA,64311,225325,289636,25,Massachusetts
2020-05-01,MD,23472,97511,120983,24,Maryland
2020-05-01,ME,1123,19546,20669,23,Maine
2020-05-01,MI,48240,178807,227047,26,Michigan
2020-05-01,MN,8736,77214,85950,27,Minnesota
2020-05-01,MO,7835,74590,82425,29,Missouri
2020-05-01,MP,14,749,763,69,Northern Mariana Islands
2020-05-01,MS,7212,64336,71548,28,Mississippi
2020-05-01,MT,453,13750,14203,30,Montana
2020-05-01,NC,10923,122909,133832,37,North Carolina
2020-05-01,ND,1107,28418,29525,38,North Dakota
2020-05-01,NE,4281,23104,27385,31,Nebraska
2020-05-01,NH,2146,19903,22049,33,New Hampshire
2020-05-01,NJ,121190,135355,256545,34,New Jersey
2020-05-01,NM,3411,64458,67869,35,New Mexico
2020-05-01,NV,5227,38368,43595,32,Nevada
2020-05-01,NY,308314,619124,927438,36,New York
2020-05-01,OH,18743,121763,140506,39,Ohio
2020-05-01,OK,3748,59804,63552,40,Oklahoma
2020-05-01,OR,2579,55597,58176,41,Oregon
2020-05-01,PA,46971,180477,227448,42,Pennsylvania
2020-05-01,PR,1575,9313,10888,72,Puerto Rico
2020-05-01,RI,9333,52328,61661,44,Rhode Island
2020-05-01,SC,6258,53121,59379,45,South Carolina
2020-05-01,SD,2525,14838,17363,46,South Dakota
2020-05-01,TN,11891,174241,186132,47,Tennessee
2020-05-01,TX,29229,322546,351775,48,Texas
2020-05-01,UT,4828,107730,112558,49,Utah
2020-05-01,VA,16901,89539,106440,51,Virginia
2020-05-01,VI,66,811,877,78,U.S. Virgin Islands
2020-05-01,VT,885,14930,15815,50,Vermont
2020-05-01,WA,16653,193449,210102,53,Washington
2020-05-01,WI,8550,72566,81116,55,Wisconsin
2020-05-01,WV,1136,45708,46844,54,West Virginia
2020-05-01,WY,559,9136,9695,56,Wyoming
2020-04-30,AK,355,18764,19119,02,Alaska
2020-04-30,AL,7019,80177,87196,01,Alabama
2020-04-30,AR,3255,45124,48379,05,Arkansas
2020-04-30,AS,0,3,3,60,American Samoa
2020-04-30,AZ,7648,64138,71786,04,Arizona
2020-04-30,CA,48917,576420,625337,06,California
2020-04-30,CO,14758,56301,71059,08,Colorado
2020-04-30,CT,27700,69433,97133,09,Connecticut
2020-04-30,DC,4323,15756,20079,11,District of Columbia
2020-04-30,DE,4734,17086,21820,10,Delaware
2020-04-30,FL,33690,348715,382405,12,Florida
2020-04-30,GA,26155,122889,149044,13,Georgia
2020-04-30,GU,146,1962,2108,66,Guam
2020-04-30,HI,613,30027,30640,15,Hawaii
2020-04-30,IA,7145,35522,42667,19,Iowa
2020-04-30,ID,1984,26862,28846,16,Idaho
2020-04-30,IL,52918,216949,269867,17,Illinois
2020-04-30,IN,17835,77163,94998,18,Indiana
2020-04-30,KS,4238,27388,31626,20,Kansas
2020-04-30,KY,4539,49562,54101,21,Kentucky
2020-04-30,LA,28001,133308,161309,22,Louisiana
2020-04-30,MA,62205,213442,275647,25,Massachusetts
2020-04-30,MD,21742,92617,114359,24,Maryland
2020-04-30,ME,1095,19546,20641,23,Maine
2020-04-30,MI,47505,168944,216449,26,Michigan
2020-04-30,MN,8116,73349,81465,27,Minnesota
2020-04-30,MO,7562,73125,80687,29,Missouri
2020-04-30,MP,14,585,599,69,Northern Mariana Islands
2020-04-30,MS,6815,59525,66340,28,Mississippi
2020-04-30,MT,453,13461,13914,30,Montana
2020-04-30,NC,10509,117527,128036,37,North Carolina
2020-04-30,ND,1067,26393,27460,38,North Dakota
2020-04-30,NE,3784,21537,25321,31,Nebraska
2020-04-30,NH,2054,19867,21921,33,New Hampshire
2020-04-30,NJ,118652,129266,247918,34,New Jersey
2020-04-30,NM,3213,61872,65085,35,New Mexico
2020-04-30,NV,4998,36988,41986,32,Nevada
2020-04-30,NY,304372,596264,900636,36,New York
2020-04-30,OH,18027,115863,133890,39,Ohio
2020-04-30,OK,3618,59804,63422,40,Oklahoma
2020-04-30,OR,2510,53522,56032,41,Oregon
2020-04-30,PA,45763,175602,221365,42,Pennsylvania
2020-04-30,PR,1539,9313,10852,72,Puerto Rico
2020-04-30,RI,9016,50100,59116,44,Rhode Island
2020-04-30,SC,6095,50417,56512,45,South Carolina
2020-04-30,SD,2449,14579,17028,46,South Dakota
2020-04-30,TN,10735,166891,177626,47,Tennessee
2020-04-30,TX,28087,302213,330300,48,Texas
2020-04-30,UT,4672,103829,108501,49,Utah
2020-04-30,VA,15846,75663,91509,51,Virginia
2020-04-30,VI,66,807,873,78,U.S. Virgin Islands
2020-04-30,VT,879,14357,15236,50,Vermont
2020-04-30,WA,16309,189001,205310,53,Washington
2020-04-30,WI,8052,69394,77446,55,Wisconsin
2020-04-30,WV,1118,43423,44541,54,West Virginia
2020-04-30,WY,544,8902,9446,56,Wyoming
2020-04-29,AK,355,18764,19119,02,Alaska
2020-04-29,AL,6842,73607,80449,01,Alabama
2020-04-29,AR,3192,42257,45449,05,Arkansas
2020-04-29,AS,0,3,3,60,American Samoa
2020-04-29,AZ,7202,61611,68813,04,Arizona
2020-04-29,CA,46500,556639,603139,06,California
2020-04-29,CO,14735,54714,69449,08,Colorado
2020-04-29,CT,26767,68051,94818,09,Connecticut
2020-04-29,DC,4106,15123,19229,11,District of Columbia
2020-04-29,DE,4655,16883,21538,10,Delaware
2020-04-29,FL,33193,340295,373488,12,Florida
2020-04-29,GA,25623,118155,143778,13,Georgia
2020-04-29,GU,145,1702,1847,66,Guam
2020-04-29,HI,609,29009,29618,15,Hawaii
2020-04-29,IA,6843,34494,41337,19,Iowa
2020-04-29,ID,1952,26430,28382,16,Idaho
2020-04-29,IL,50355,206312,256667,17,Illinois
2020-04-29,IN,17182,74368,91550,18,Indiana
2020-04-29,KS,3738,25720,29458,20,Kansas
2020-04-29,KY,4375,48036,52411,21,Kentucky
2020-04-29,LA,27660,128908,156568,22,Louisiana
2020-04-29,MA,60265,205353,265618,25,Massachusetts
2020-04-29,MD,20849,90080,110929,24,Maryland
2020-04-29,ME,1056,19546,20602,23,Maine
2020-04-29,MI,46488,158373,204861,26,Michigan
2020-04-29,MN,7468,69650,77118,27,Minnesota
2020-04-29,MO,7425,69734,77159,29,Missouri
2020-04-29,MP,14,210,224,69,Northern Mariana Islands
2020-04-29,MS,6569,59525,66094,28,Mississippi
2020-04-29,MT,451,13077,13528,30,Montana
2020-04-29,NC,9948,108492,118440,37,North Carolina
2020-04-29,ND,1033,24503,25536,38,North Dakota
2020-04-29,NE,3374,20257,23631,31,Nebraska
2020-04-29,NH,2010,18736,20746,33,New Hampshire
2020-04-29,NJ,116264,125054,241318,34,New Jersey
2020-04-29,NM,2974,58771,61745,35,New Mexico
2020-04-29,NV,4898,36130,41028,32,Nevada
2020-04-29,NY,299691,572790,872481,36,New York
2020-04-29,OH,17303,111605,128908,39,Ohio
2020-04-29,OK,3473,57794,61267,40,Oklahoma
2020-04-29,OR,2446,52026,54472,41,Oregon
2020-04-29,PA,44366,170517,214883,42,Pennsylvania
2020-04-29,PR,1433,9313,10746,72,Puerto Rico
2020-04-29,RI,8668,48143,56811,44,Rhode Island
2020-04-29,SC,5881,48336,54217,45,South Carolina
2020-04-29,SD,2373,14460,16833,46,South Dakota
2020-04-29,TN,10366,158183,168549,47,Tennessee
2020-04-29,TX,27054,287736,314790,48,Texas
2020-04-29,UT,4495,101283,105778,49,Utah
2020-04-29,VA,14961,70979,85940,51,Virginia
2020-04-29,VI,62,732,794,78,U.S. Virgin Islands
2020-04-29,VT,866,14155,15021,50,Vermont
2020-04-29,WA,16042,184386,200428,53,Washington
2020-04-29,WI,7660,66630,74290,55,Wisconsin
2020-04-29,WV,1095,41976,43071,54,West Virginia
2020-04-29,WY,536,8681,9217,56,Wyoming
2020-04-28,AK,351,16738,17089,02,Alaska
2020-04-28,AL,6687,69140,75827,01,Alabama
2020-04-28,AR,3111,37560,40671,05,Arkansas
2020-04-28,AS,0,3,3,60,American Samoa
2020-04-28,AZ,6948,60490,67438,04,Arizona
2020-04-28,CA,45031,532577,577608,06,California
2020-04-28,CO,13879,52462,66341,08,Colorado
2020-04-28,CT,26312,66433,92745,09,Connecticut
2020-04-28,DC,3994,14891,18885,11,District of Columbia
2020-04-28,DE,4575,16605,21180,10,Delaware
2020-04-28,FL,32846,334029,366875,12,Florida
2020-04-28,GA,24615,115405,140020,13,Georgia
2020-04-28,GU,145,1538,1683,66,Guam
2020-04-28,HI,607,28576,29183,15,Hawaii
2020-04-28,IA,6376,33447,39823,19,Iowa
2020-04-28,ID,1917,18135,20052,16,Idaho
2020-04-28,IL,48102,194087,242189,17,Illinois
2020-04-28,IN,16588,70593,87181,18,Indiana
2020-04-28,KS,3491,24599,28090,20,Kansas
2020-04-28,KY,4146,44653,48799,21,Kentucky
2020-04-28,LA,27286,123822,151108,22,Louisiana
2020-04-28,MA,58302,196198,254500,25,Massachusetts
2020-04-28,MD,20113,87672,107785,24,Maryland
2020-04-28,ME,1040,16784,17824,23,Maine
2020-04-28,MI,45538,148910,194448,26,Michigan
2020-04-28,MN,6788,63248,70036,27,Minnesota
2020-04-28,MO,7303,66200,73503,29,Missouri
2020-04-28,MP,14,51,65,69,Northern Mariana Islands
2020-04-28,MS,6342,58070,64412,28,Mississippi
2020-04-28,MT,451,12740,13191,30,Montana
2020-04-28,NC,9568,103184,112752,37,North Carolina
2020-04-28,ND,991,22732,23723,38,North Dakota
2020-04-28,NE,3358,20247,23605,31,Nebraska
2020-04-28,NH,1938,18207,20145,33,New Hampshire
2020-04-28,NJ,113856,120503,234359,34,New Jersey
2020-04-28,NM,2823,55980,58803,35,New Mexico
2020-04-28,NV,4805,35314,40119,32,Nevada
2020-04-28,NY,295106,549888,844994,36,New York
2020-04-28,OH,16769,106578,123347,39,Ohio
2020-04-28,OK,3410,56289,59699,40,Oklahoma
2020-04-28,OR,2354,48844,51198,41,Oregon
2020-04-28,PA,43264,165824,209088,42,Pennsylvania
2020-04-28,PR,1400,9313,10713,72,Puerto Rico
2020-04-28,RI,8296,45689,53985,44,Rhode Island
2020-04-28,SC,5613,46532,52145,45,South Carolina
2020-04-28,SD,2313,14299,16612,46,South Dakota
2020-04-28,TN,10052,151876,161928,47,Tennessee
2020-04-28,TX,26171,274213,300384,48,Texas
2020-04-28,UT,4343,98096,102439,49,Utah
2020-04-28,VA,14339,68959,83298,51,Virginia
2020-04-28,VI,59,719,778,78,U.S. Virgin Islands
2020-04-28,VT,862,13947,14809,50,Vermont
2020-04-28,WA,15798,179707,195505,53,Washington
2020-04-28,WI,7391,63535,70926,55,Wisconsin
2020-04-28,WV,1079,41976,43055,54,West Virginia
2020-04-28,WY,389,8226,8615,56,Wyoming
2020-04-27,AK,345,15911,16256,02,Alaska
2020-04-27,AL,6499,67498,73997,01,Alabama
2020-04-27,AR,3017,37440,40457,05,Arkansas
2020-04-27,AS,0,3,3,60,American Samoa
2020-04-27,AZ,6716,59827,66543,04,Arizona
2020-04-27,CA,43464,509945,553409,06,California
2020-04-27,CO,13441,49833,63274,08,Colorado
2020-04-27,CT,25269,54542,79811,09,Connecticut
2020-04-27,DC,3892,14524,18416,11,District of Columbia
2020-04-27,DE,4162,15454,19616,10,Delaware
2020-04-27,FL,32138,324325,356463,12,Florida
2020-04-27,GA,23913,103256,127169,13,Georgia
2020-04-27,GU,144,1424,1568,66,Guam
2020-04-27,HI,606,28404,29010,15,Hawaii
2020-04-27,IA,5868,32282,38150,19,Iowa
2020-04-27,ID,1897,18127,20024,16,Idaho
2020-04-27,IL,45883,181745,227628,17,Illinois
2020-04-27,IN,15961,68515,84476,18,Indiana
2020-04-27,KS,3328,23839,27167,20,Kansas
2020-04-27,KY,4074,44400,48474,21,Kentucky
2020-04-27,LA,27068,119921,146989,22,Louisiana
2020-04-27,MA,56462,188425,244887,25,Massachusetts
2020-04-27,MD,19487,85489,104976,24,Maryland
2020-04-27,ME,1023,16784,17807,23,Maine
2020-04-27,MI,44709,140972,185681,26,Michigan
2020-04-27,MN,6187,60503,66690,27,Minnesota
2020-04-27,MO,7171,63935,71106,29,Missouri
2020-04-27,MP,14,51,65,69,Northern Mariana Islands
2020-04-27,MS,6094,57368,63462,28,Mississippi
2020-04-27,MT,449,12584,13033,30,Montana
2020-04-27,NC,9142,100778,109920,37,North Carolina
2020-04-27,ND,942,21492,22434,38,North Dakota
2020-04-27,NE,3028,19335,22363,31,Nebraska
2020-04-27,NH,1864,17860,19724,33,New Hampshire
2020-04-27,NJ,111188,116587,227775,34,New Jersey
2020-04-27,NM,2726,53889,56615,35,New Mexico
2020-04-27,NV,4690,34123,38813,32,Nevada
2020-04-27,NY,291996,534099,826095,36,New York
2020-04-27,OH,16325,103692,120017,39,Ohio
2020-04-27,OK,3280,49891,53171,40,Oklahoma
2020-04-27,OR,2354,48844,51198,41,Oregon
2020-04-27,PA,42050,161372,203422,42,Pennsylvania
2020-04-27,PR,1389,9313,10702,72,Puerto Rico
2020-04-27,RI,7972,43915,51887,44,Rhode Island
2020-04-27,SC,5490,45271,50761,45,South Carolina
2020-04-27,SD,2245,14130,16375,46,South Dakota
2020-04-27,TN,9918,144484,154402,47,Tennessee
2020-04-27,TX,25297,265220,290517,48,Texas
2020-04-27,UT,4233,95962,100195,49,Utah
2020-04-27,VA,13535,67144,80679,51,Virginia
2020-04-27,VI,59,716,775,78,U.S. Virgin Islands
2020-04-27,VT,862,13819,14681,50,Vermont
2020-04-27,WA,15566,174592,190158,53,Washington
2020-04-27,WI,7161,61311,68472,55,Wisconsin
2020-04-27,WV,1063,41976,43039,54,West Virginia
2020-04-27,WY,370,7797,8167,56,Wyoming
2020-04-26,AK,341,15836,16177,02,Alaska
2020-04-26,AL,6270,67281,73551,01,Alabama
2020-04-26,AR,2941,36528,39469,05,Arkansas
2020-04-26,AS,0,3,3,60,American Samoa
2020-04-26,AZ,6526,58285,64811,04,Arizona
2020-04-26,CA,42164,483920,526084,06,California
2020-04-26,CO,12968,46823,59791,08,Colorado
2020-04-26,CT,25269,54542,79811,09,Connecticut
2020-04-26,DC,3841,14227,18068,11,District of Columbia
2020-04-26,DE,4034,15215,19249,10,Delaware
2020-04-26,FL,31528,313085,344613,12,Florida
2020-04-26,GA,23401,99822,123223,13,Georgia
2020-04-26,GU,141,1387,1528,66,Guam
2020-04-26,HI,603,27880,28483,15,Hawaii
2020-04-26,IA,5476,30614,36090,19,Iowa
2020-04-26,ID,1887,17611,19498,16,Idaho
2020-04-26,IL,43903,171049,214952,17,Illinois
2020-04-26,IN,15012,66696,81708,18,Indiana
2020-04-26,KS,3174,23053,26227,20,Kansas
2020-04-26,KY,3905,42653,46558,21,Kentucky
2020-04-26,LA,26773,116263,143036,22,Louisiana
2020-04-26,MA,54938,181162,236100,25,Massachusetts
2020-04-26,MD,18581,78084,96665,24,Maryland
2020-04-26,ME,1015,16784,17799,23,Maine
2020-04-26,MI,43789,134431,178220,26,Michigan
2020-04-26,MN,5512,59161,64673,27,Minnesota
2020-04-26,MO,6997,62751,69748,29,Missouri
2020-04-26,MP,14,51,65,69,Northern Mariana Islands
2020-04-26,MS,5911,54877,60788,28,Mississippi
2020-04-26,MT,448,12414,12862,30,Montana
2020-04-26,NC,8830,99064,107894,37,North Carolina
2020-04-26,ND,867,19850,20717,38,North Dakota
2020-04-26,NE,2732,18496,21228,31,Nebraska
2020-04-26,NH,1787,16964,18751,33,New Hampshire
2020-04-26,NJ,109038,114106,223144,34,New Jersey
2020-04-26,NM,2660,51075,53735,35,New Mexico
2020-04-26,NV,4602,33584,38186,32,Nevada
2020-04-26,NY,288045,517305,805350,36,New York
2020-04-26,OH,15963,100423,116386,39,Ohio
2020-04-26,OK,3253,49891,53144,40,Oklahoma
2020-04-26,OR,2311,46653,48964,41,Oregon
2020-04-26,PA,41165,157428,198593,42,Pennsylvania
2020-04-26,PR,1371,9313,10684,72,Puerto Rico
2020-04-26,RI,7769,42746,50515,44,Rhode Island
2020-04-26,SC,5490,45271,50761,45,South Carolina
2020-04-26,SD,2212,14062,16274,46,South Dakota
2020-04-26,TN,9667,137807,147474,47,Tennessee
2020-04-26,TX,24631,251390,276021,48,Texas
2020-04-26,UT,4123,91579,95702,49,Utah
2020-04-26,VA,12970,63630,76600,51,Virginia
2020-04-26,VI,57,700,757,78,U.S. Virgin Islands
2020-04-26,VT,855,13518,14373,50,Vermont
2020-04-26,WA,15292,169749,185041,53,Washington
2020-04-26,WI,6963,59235,66198,55,Wisconsin
2020-04-26,WV,1044,38019,39063,54,West Virginia
2020-04-26,WY,362,7797,8159,56,Wyoming
2020-04-25,AK,339,15393,15732,02,Alaska
2020-04-25,AL,6137,65207,71344,01,Alabama
2020-04-25,AR,2829,35224,38053,05,Arkansas
2020-04-25,AS,0,3,3,60,American Samoa
2020-04-25,AZ,6280,56228,62508,04,Arizona
2020-04-25,CA,41137,464898,506035,06,California
2020-04-25,CO,12256,44533,56789,08,Colorado
2020-04-25,CT,24582,53020,77602,09,Connecticut
2020-04-25,DC,3699,13603,17302,11,District of Columbia
2020-04-25,DE,3576,14122,17698,10,Delaware
2020-04-25,FL,30839,302260,333099,12,Florida
2020-04-25,GA,22695,96319,119014,13,Georgia
2020-04-25,GU,141,1308,1449,66,Guam
2020-04-25,HI,601,27439,28040,15,Hawaii
2020-04-25,IA,5092,29258,34350,19,Iowa
2020-04-25,ID,1870,17611,19481,16,Idaho
2020-04-25,IL,41777,159840,201617,17,Illinois
2020-04-25,IN,14395,65379,79774,18,Indiana
2020-04-25,KS,3056,22143,25199,20,Kansas
2020-04-25,KY,3779,41183,44962,21,Kentucky
2020-04-25,LA,26512,112490,139002,22,Louisiana
2020-04-25,MA,53348,173497,226845,25,Massachusetts
2020-04-25,MD,17766,71357,89123,24,Maryland
2020-04-25,ME,990,16784,17774,23,Maine
2020-04-25,MI,43263,128955,172218,26,Michigan
2020-04-25,MN,5127,56982,62109,27,Minnesota
2020-04-25,MO,6826,60392,67218,29,Missouri
2020-04-25,MP,14,51,65,69,Northern Mariana Islands
2020-04-25,MS,5718,53239,58957,28,Mississippi
2020-04-25,MT,445,12052,12497,30,Montana
2020-04-25,NC,8623,96642,105265,37,North Carolina
2020-04-25,ND,803,18547,19350,38,North Dakota
2020-04-25,NE,2421,17552,19973,31,Nebraska
2020-04-25,NH,1720,16007,17727,33,New Hampshire
2020-04-25,NJ,105523,108163,213686,34,New Jersey
2020-04-25,NM,2521,48989,51510,35,New Mexico
2020-04-25,NV,4539,32669,37208,32,Nevada
2020-04-25,NY,282143,495425,777568,36,New York
2020-04-25,OH,15587,96396,111983,39,Ohio
2020-04-25,OK,3193,49891,53084,40,Oklahoma
2020-04-25,OR,2253,45124,47377,41,Oregon
2020-04-25,PA,40049,152886,192935,42,Pennsylvania
2020-04-25,PR,1307,9313,10620,72,Puerto Rico
2020-04-25,RI,7493,40860,48353,44,Rhode Island
2020-04-25,SC,5253,43761,49014,45,South Carolina
2020-04-25,SD,2147,13449,15596,46,South Dakota
2020-04-25,TN,9189,132217,141406,47,Tennessee
2020-04-25,TX,23773,239043,262816,48,Texas
2020-04-25,UT,3948,86258,90206,49,Utah
2020-04-25,VA,12366,60276,72642,51,Virginia
2020-04-25,VI,55,693,748,78,U.S. Virgin Islands
2020-04-25,VT,852,13270,14122,50,Vermont
2020-04-25,WA,15110,168153,183263,53,Washington
2020-04-25,WI,6715,57138,63853,55,Wisconsin
2020-04-25,WV,1020,31946,32966,54,West Virginia
2020-04-25,WY,349,7797,8146,56,Wyoming
2020-04-24,AK,339,11942,12281,02,Alaska
2020-04-24,AL,5832,46863,52695,01,Alabama
2020-04-24,AR,2741,32837,35578,05,Arkansas
2020-04-24,AS,0,3,3,60,American Samoa
2020-04-24,AZ,6045,54669,60714,04,Arizona
2020-04-24,CA,39254,454919,494173,06,California
2020-04-24,CO,11262,41062,52324,08,Colorado
2020-04-24,CT,23921,50117,74038,09,Connecticut
2020-04-24,DC,3528,13005,16533,11,District of Columbia
2020-04-24,DE,3442,13937,17379,10,Delaware
2020-04-24,FL,30174,286785,316959,12,Florida
2020-04-24,GA,22147,85029,107176,13,Georgia
2020-04-24,GU,141,1233,1374,66,Guam
2020-04-24,HI,596,26291,26887,15,Hawaii
2020-04-24,IA,4445,27528,31973,19,Iowa
2020-04-24,ID,1836,17611,19447,16,Idaho
2020-04-24,IL,39658,149974,189632,17,Illinois
2020-04-24,IN,13680,61873,75553,18,Indiana
2020-04-24,KS,2777,20811,23588,20,Kansas
2020-04-24,KY,3481,39363,42844,21,Kentucky
2020-04-24,LA,26140,111972,138112,22,Louisiana
2020-04-24,MA,50969,164244,215213,25,Massachusetts
2020-04-24,MD,16616,68100,84716,24,Maryland
2020-04-24,ME,965,16784,17749,23,Maine
2020-04-24,MI,42730,123054,165784,26,Michigan
2020-04-24,MN,4788,54706,59494,27,Minnesota
2020-04-24,MO,6625,58582,65207,29,Missouri
2020-04-24,MP,14,51,65,69,Northern Mariana Islands
2020-04-24,MS,5434,50236,55670,28,Mississippi
2020-04-24,MT,444,11683,12127,30,Montana
2020-04-24,NC,8052,92532,100584,37,North Carolina
2020-04-24,ND,748,16701,17449,38,North Dakota
2020-04-24,NE,2124,16488,18612,31,Nebraska
2020-04-24,NH,1670,15139,16809,33,New Hampshire
2020-04-24,NJ,102196,103766,205962,34,New Jersey
2020-04-24,NM,2379,44184,46563,35,New Mexico
2020-04-24,NV,4398,31794,36192,32,Nevada
2020-04-24,NY,271590,459066,730656,36,New York
2020-04-24,OH,15169,92528,107697,39,Ohio
2020-04-24,OK,3121,43019,46140,40,Oklahoma
2020-04-24,OR,2177,43315,45492,41,Oregon
2020-04-24,PA,38652,147491,186143,42,Pennsylvania
2020-04-24,PR,1276,9313,10589,72,Puerto Rico
2020-04-24,RI,7188,39071,46259,44,Rhode Island
2020-04-24,SC,4917,39546,44463,45,South Carolina
2020-04-24,SD,2040,12784,14824,46,South Dakota
2020-04-24,TN,8726,122602,131328,47,Tennessee
2020-04-24,TX,22806,219741,242547,48,Texas
2020-04-24,UT,3782,80915,84697,49,Utah
2020-04-24,VA,11594,57846,69440,51,Virginia
2020-04-24,VI,54,642,696,78,U.S. Virgin Islands
2020-04-24,VT,843,12808,13651,50,Vermont
2020-04-24,WA,14913,165339,180252,53,Washington
2020-04-24,WI,6364,54573,60937,55,Wisconsin
2020-04-24,WV,988,28823,29811,54,West Virginia
2020-04-24,WY,349,7696,8045,56,Wyoming
2020-04-23,AK,337,11824,12161,02,Alaska
2020-04-23,AL,5778,46863,52641,01,Alabama
2020-04-23,AR,2465,29125,31590,05,Arkansas
2020-04-23,AS,0,3,3,60,American Samoa
2020-04-23,AZ,5769,52928,58697,04,Arizona
2020-04-23,CA,37369,444728,482097,06,California
2020-04-23,CO,10878,39767,50645,08,Colorado
2020-04-23,CT,23100,48397,71497,09,Connecticut
2020-04-23,DC,3361,12569,15930,11,District of Columbia
2020-04-23,DE,3308,13604,16912,10,Delaware
2020-04-23,FL,28832,267876,296708,12,Florida
2020-04-23,GA,21512,79550,101062,13,Georgia
2020-04-23,GU,135,1180,1315,66,Guam
2020-04-23,HI,592,25536,26128,15,Hawaii
2020-04-23,IA,3924,25338,29262,19,Iowa
2020-04-23,ID,1802,17370,19172,16,Idaho
2020-04-23,IL,36934,136382,173316,17,Illinois
2020-04-23,IN,13039,59001,72040,18,Indiana
2020-04-23,KS,2482,18836,21318,20,Kansas
2020-04-23,KY,3373,32702,36075,21,Kentucky
2020-04-23,LA,25739,111774,137513,22,Louisiana
2020-04-23,MA,47992,156324,204316,25,Massachusetts
2020-04-23,MD,15737,64363,80100,24,Maryland
2020-04-23,ME,937,16784,17721,23,Maine
2020-04-23,MI,41694,115005,156699,26,Michigan
2020-04-23,MN,4270,52144,56414,27,Minnesota
2020-04-23,MO,6321,53129,59450,29,Missouri
2020-04-23,MP,14,51,65,69,Northern Mariana Islands
2020-04-23,MS,5153,50236,55389,28,Mississippi
2020-04-23,MT,442,11433,11875,30,Montana
2020-04-23,NC,7608,88577,96185,37,North Carolina
2020-04-23,ND,709,15621,16330,38,North Dakota
2020-04-23,NE,1813,15547,17360,31,Nebraska
2020-04-23,NH,1588,14424,16012,33,New Hampshire
2020-04-23,NJ,99989,100159,200148,34,New Jersey
2020-04-23,NM,2210,39022,41232,35,New Mexico
2020-04-23,NV,4208,30541,34749,32,Nevada
2020-04-23,NY,263460,432460,695920,36,New York
2020-04-23,OH,14694,88183,102877,39,Ohio
2020-04-23,OK,3017,43019,46036,40,Oklahoma
2020-04-23,OR,2127,41849,43976,41,Oregon
2020-04-23,PA,37053,142061,179114,42,Pennsylvania
2020-04-23,PR,915,9313,10228,72,Puerto Rico
2020-04-23,RI,6773,36423,43196,44,Rhode Island
2020-04-23,SC,4917,39546,44463,45,South Carolina
2020-04-23,SD,1956,12109,14065,46,South Dakota
2020-04-23,TN,8266,114834,123100,47,Tennessee
2020-04-23,TX,21944,203134,225078,48,Texas
2020-04-23,UT,3612,77015,80627,49,Utah
2020-04-23,VA,10998,53891,64889,51,Virginia
2020-04-23,VI,54,583,637,78,U.S. Virgin Islands
2020-04-23,VT,834,12420,13254,50,Vermont
2020-04-23,WA,14628,160115,174743,53,Washington
2020-04-23,WI,6011,51456,57467,55,Wisconsin
2020-04-23,WV,967,26938,27905,54,West Virginia
2020-04-23,WY,326,7241,7567,56,Wyoming
2020-04-22,AK,335,11824,12159,02,Alaska
2020-04-22,AL,5465,43295,48760,01,Alabama
2020-04-22,AR,2276,27437,29713,05,Arkansas
2020-04-22,AS,0,3,3,60,American Samoa
2020-04-22,AZ,5459,51142,56601,04,Arizona
2020-04-22,CA,35396,429931,465327,06,California
2020-04-22,CO,10447,38257,48704,08,Colorado
2020-04-22,CT,22469,47449,69918,09,Connecticut
2020-04-22,DC,3206,12296,15502,11,District of Columbia
2020-04-22,DE,3200,13353,16553,10,Delaware
2020-04-22,FL,28309,260318,288627,12,Florida
2020-04-22,GA,20740,73332,94072,13,Georgia
2020-04-22,GU,134,1086,1220,66,Guam
2020-04-22,HI,586,24760,25346,15,Hawaii
2020-04-22,IA,3748,24496,28244,19,Iowa
2020-04-22,ID,1766,16404,18170,16,Idaho
2020-04-22,IL,35108,129238,164346,17,Illinois
2020-04-22,IN,12438,57032,69470,18,Indiana
2020-04-22,KS,2211,17992,20203,20,Kansas
2020-04-22,KY,3192,30136,33328,21,Kentucky
2020-04-22,LA,25258,111588,136846,22,Louisiana
2020-04-22,MA,44913,144789,189702,25,Massachusetts
2020-04-22,MD,14775,61754,76529,24,Maryland
2020-04-22,ME,907,16784,17691,23,Maine
2020-04-22,MI,40705,106653,147358,26,Michigan
2020-04-22,MN,3758,50165,53923,27,Minnesota
2020-04-22,MO,6137,52019,58156,29,Missouri
2020-04-22,MP,14,51,65,69,Northern Mariana Islands
2020-04-22,MS,4894,48941,53835,28,Mississippi
2020-04-22,MT,439,11144,11583,30,Montana
2020-04-22,NC,7220,83116,90336,37,North Carolina
2020-04-22,ND,679,14910,15589,38,North Dakota
2020-04-22,NE,1722,14957,16679,31,Nebraska
2020-04-22,NH,1491,13550,15041,33,New Hampshire
2020-04-22,NJ,95865,95794,191659,34,New Jersey
2020-04-22,NM,2072,38805,40877,35,New Mexico
2020-04-22,NV,4081,29807,33888,32,Nevada
2020-04-22,NY,257216,412766,669982,36,New York
2020-04-22,OH,14117,84389,98506,39,Ohio
2020-04-22,OK,2894,43019,45913,40,Oklahoma
2020-04-22,OR,2059,39126,41185,41,Oregon
2020-04-22,PA,35684,136272,171956,42,Pennsylvania
2020-04-22,PR,915,8842,9757,72,Puerto Rico
2020-04-22,RI,6354,34528,40882,44,Rhode Island
2020-04-22,SC,4761,38350,43111,45,South Carolina
2020-04-22,SD,1858,11588,13446,46,South Dakota
2020-04-22,TN,7842,107138,114980,47,Tennessee
2020-04-22,TX,21069,195714,216783,48,Texas
2020-04-22,UT,3445,73015,76460,49,Utah
2020-04-22,VA,10266,50512,60778,51,Virginia
2020-04-22,VI,54,583,637,78,U.S. Virgin Islands
2020-04-22,VT,831,12097,12928,50,Vermont
2020-04-22,WA,14375,156030,170405,53,Washington
2020-04-22,WI,5766,49502,55268,55,Wisconsin
2020-04-22,WV,939,24897,25836,54,West Virginia
2020-04-22,WY,322,7301,7623,56,Wyoming
2020-04-21,AK,329,10790,11119,02,Alaska
2020-04-21,AL,5231,43295,48526,01,Alabama
2020-04-21,AR,2227,25214,27441,05,Arkansas
2020-04-21,AS,0,3,3,60,American Samoa
2020-04-21,AZ,5251,49901,55152,04,Arizona
2020-04-21,CA,33261,266839,300100,06,California
2020-04-21,CO,10106,37360,47466,08,Colorado
2020-04-21,CT,20360,43832,64192,09,Connecticut
2020-04-21,DC,3098,11841,14939,11,District of Columbia
2020-04-21,DE,2931,12935,15866,10,Delaware
2020-04-21,FL,27495,249564,277059,12,Florida
2020-04-21,GA,19881,68259,88140,13,Georgia
2020-04-21,GU,133,1033,1166,66,Guam
2020-04-21,HI,584,24112,24696,15,Hawaii
2020-04-21,IA,3641,23974,27615,19,Iowa
2020-04-21,ID,1736,16071,17807,16,Idaho
2020-04-21,IL,33059,121938,154997,17,Illinois
2020-04-21,IN,12097,55167,67264,18,Indiana
2020-04-21,KS,2025,17076,19101,20,Kansas
2020-04-21,KY,3050,29770,32820,21,Kentucky
2020-04-21,LA,24854,111588,136442,22,Louisiana
2020-04-21,MA,43168,141444,184612,25,Massachusetts
2020-04-21,MD,14193,59442,73635,24,Maryland
2020-04-21,ME,888,14076,14964,23,Maine
2020-04-21,MI,39589,99667,139256,26,Michigan
2020-04-21,MN,3452,48341,51793,27,Minnesota
2020-04-21,MO,5941,51179,57120,29,Missouri
2020-04-21,MP,14,51,65,69,Northern Mariana Islands
2020-04-21,MS,4716,47648,52364,28,Mississippi
2020-04-21,MT,437,10804,11241,30,Montana
2020-04-21,NC,6951,76380,83331,37,North Carolina
2020-04-21,ND,644,14343,14987,38,North Dakota
2020-04-21,NE,1648,14724,16372,31,Nebraska
2020-04-21,NH,1491,12848,14339,33,New Hampshire
2020-04-21,NJ,92387,92439,184826,34,New Jersey
2020-04-21,NM,1971,36784,38755,35,New Mexico
2020-04-21,NV,3937,29118,33055,32,Nevada
2020-04-21,NY,251690,397635,649325,36,New York
2020-04-21,OH,13725,80989,94714,39,Ohio
2020-04-21,OK,2807,41537,44344,40,Oklahoma
2020-04-21,OR,2002,39126,41128,41,Oregon
2020-04-21,PA,34528,132323,166851,42,Pennsylvania
2020-04-21,PR,1298,8789,10087,72,Puerto Rico
2020-04-21,RI,5972,32606,38578,44,Rhode Island
2020-04-21,SC,4439,36838,41277,45,South Carolina
2020-04-21,SD,1755,11060,12815,46,South Dakota
2020-04-21,TN,7394,100788,108182,47,Tennessee
2020-04-21,TX,20196,185203,205399,48,Texas
2020-04-21,UT,3296,69062,72358,49,Utah
2020-04-21,VA,9630,48724,58354,51,Virginia
2020-04-21,VI,54,574,628,78,U.S. Virgin Islands
2020-04-21,VT,828,11767,12595,50,Vermont
2020-04-21,WA,14133,151848,165981,53,Washington
2020-04-21,WI,5509,47841,53350,55,Wisconsin
2020-04-21,WV,914,21849,22763,54,West Virginia
2020-04-21,WY,320,7301,7621,56,Wyoming
2020-04-20,AK,321,9803,10124,02,Alaska
2020-04-20,AL,5025,40875,45900,01,Alabama
2020-04-20,AR,1923,24630,26553,05,Arkansas
2020-04-20,AS,0,3,3,60,American Samoa
2020-04-20,AZ,5064,49436,54500,04,Arizona
2020-04-20,CA,30978,259522,290500,06,California
2020-04-20,CO,9730,36465,46195,08,Colorado
2020-04-20,CT,19815,42991,62806,09,Connecticut
2020-04-20,DC,2927,11186,14113,11,District of Columbia
2020-04-20,DE,2745,12508,15253,10,Delaware
2020-04-20,FL,26660,239565,266225,12,Florida
2020-04-20,GA,18947,65381,84328,13,Georgia
2020-04-20,GU,133,991,1124,66,Guam
2020-04-20,HI,580,23595,24175,15,Hawaii
2020-04-20,IA,3159,22661,25820,19,Iowa
2020-04-20,ID,1672,15773,17445,16,Idaho
2020-04-20,IL,31508,116850,148358,17,Illinois
2020-04-20,IN,11686,52953,64639,18,Indiana
2020-04-20,KS,1986,16775,18761,20,Kansas
2020-04-20,KY,2960,29612,32572,21,Kentucky
2020-04-20,LA,24523,111588,136111,22,Louisiana
2020-04-20,MA,41416,136046,177462,25,Massachusetts
2020-04-20,MD,13684,57713,71397,24,Maryland
2020-04-20,ME,875,14076,14951,23,Maine
2020-04-20,MI,38494,93393,131887,26,Michigan
2020-04-20,MN,3190,46854,50044,27,Minnesota
2020-04-20,MO,5807,50206,56013,29,Missouri
2020-04-20,MP,14,51,65,69,Northern Mariana Islands
2020-04-20,MS,4512,46922,51434,28,Mississippi
2020-04-20,MT,433,10618,11051,30,Montana
2020-04-20,NC,6764,72720,79484,37,North Carolina
2020-04-20,ND,627,14120,14747,38,North Dakota
2020-04-20,NE,1474,14206,15680,31,Nebraska
2020-04-20,NH,1392,12726,14118,33,New Hampshire
2020-04-20,NJ,88806,89251,178057,34,New Jersey
2020-04-20,NM,1845,35197,37042,35,New Mexico
2020-04-20,NV,3830,28517,32347,32,Nevada
2020-04-20,NY,247512,386349,633861,36,New York
2020-04-20,OH,12919,77920,90839,39,Ohio
2020-04-20,OK,2680,32966,35646,40,Oklahoma
2020-04-20,OR,1956,38089,40045,41,Oregon
2020-04-20,PA,33232,129720,162952,42,Pennsylvania
2020-04-20,PR,1252,8486,9738,72,Puerto Rico
2020-04-20,RI,5585,30883,36468,44,Rhode Island
2020-04-20,SC,4377,36103,40480,45,South Carolina
2020-04-20,SD,1685,10641,12326,46,South Dakota
2020-04-20,TN,7238,93451,100689,47,Tennessee
2020-04-20,TX,19458,170936,190394,48,Texas
2020-04-20,UT,3213,65098,68311,49,Utah
2020-04-20,VA,8990,47745,56735,51,Virginia
2020-04-20,VI,53,554,607,78,U.S. Virgin Islands
2020-04-20,VT,820,11671,12491,50,Vermont
2020-04-20,WA,13890,147889,161779,53,Washington
2020-04-20,WI,5353,46603,51956,55,Wisconsin
2020-04-20,WV,902,21253,22155,54,West Virginia
2020-04-20,WY,313,7073,7386,56,Wyoming
2020-04-19,AK,319,9576,9895,02,Alaska
2020-04-19,AL,4837,40875,45712,01,Alabama
2020-04-19,AR,1781,22428,24209,05,Arkansas
2020-04-19,AS,0,3,3,60,American Samoa
2020-04-19,AZ,4929,48061,52990,04,Arizona
2020-04-19,CA,30333,250567,280900,06,California
2020-04-19,CO,9433,35173,44606,08,Colorado
2020-04-19,CT,17550,40663,58213,09,Connecticut
2020-04-19,DC,2793,10906,13699,11,District of Columbia
2020-04-19,DE,2538,12256,14794,10,Delaware
2020-04-19,FL,25996,230083,256079,12,Florida
2020-04-19,GA,18301,61632,79933,13,Georgia
2020-04-19,GU,133,943,1076,66,Guam
2020-04-19,HI,574,22896,23470,15,Hawaii
2020-04-19,IA,2902,21648,24550,19,Iowa
2020-04-19,ID,1668,15773,17441,16,Idaho
2020-04-19,IL,30357,112961,143318,17,Illinois
2020-04-19,IN,11210,49932,61142,18,Indiana
2020-04-19,KS,1849,16281,18130,20,Kansas
2020-04-19,KY,2707,29518,32225,21,Kentucky
2020-04-19,LA,23928,111420,135348,22,Louisiana
2020-04-19,MA,39820,129295,169115,25,Massachusetts
2020-04-19,MD,12830,55061,67891,24,Maryland
2020-04-19,ME,867,14076,14943,23,Maine
2020-04-19,MI,37557,89758,127315,26,Michigan
2020-04-19,MN,2914,46288,49202,27,Minnesota
2020-04-19,MO,5667,48242,53909,29,Missouri
2020-04-19,MP,14,42,56,69,Northern Mariana Islands
2020-04-19,MS,4274,34791,39065,28,Mississippi
2020-04-19,MT,433,10465,10898,30,Montana
2020-04-19,NC,6493,72279,78772,37,North Carolina
2020-04-19,ND,585,13045,13630,38,North Dakota
2020-04-19,NE,1287,13288,14575,31,Nebraska
2020-04-19,NH,1342,12082,13424,33,New Hampshire
2020-04-19,NJ,85301,85387,170688,34,New Jersey
2020-04-19,NM,1798,34834,36632,35,New Mexico
2020-04-19,NV,3728,27870,31598,32,Nevada
2020-04-19,NY,242786,374769,617555,36,New York
2020-04-19,OH,11602,75697,87299,39,Ohio
2020-04-19,OK,2599,32966,35565,40,Oklahoma
2020-04-19,OR,1910,37128,39038,41,Oregon
2020-04-19,PA,32284,126570,158854,42,Pennsylvania
2020-04-19,PR,1213,8280,9493,72,Puerto Rico
2020-04-19,RI,5207,29289,34496,44,Rhode Island
2020-04-19,SC,4377,36103,40480,45,South Carolina
2020-04-19,SD,1635,10427,12062,46,South Dakota
2020-04-19,TN,7070,90028,97098,47,Tennessee
2020-04-19,TX,18923,163787,182710,48,Texas
2020-04-19,UT,3069,60486,63555,49,Utah
2020-04-19,VA,8537,46196,54733,51,Virginia
2020-04-19,VI,53,548,601,78,U.S. Virgin Islands
2020-04-19,VT,817,11450,12267,50,Vermont
2020-04-19,WA,13583,143808,157391,53,Washington
2020-04-19,WI,5176,45323,50499,55,Wisconsin
2020-04-19,WV,863,19168,20031,54,West Virginia
2020-04-19,WY,309,6972,7281,56,Wyoming
2020-04-18,AK,314,9341,9655,02,Alaska
2020-04-18,AL,4655,37883,42538,01,Alabama
2020-04-18,AR,1739,22402,24141,05,Arkansas
2020-04-18,AS,0,3,3,60,American Samoa
2020-04-18,AZ,4719,46326,51045,04,Arizona
2020-04-18,CA,28963,230703,259666,06,California
2020-04-18,CO,9047,34260,43307,08,Colorado
2020-04-18,CT,16809,38653,55462,09,Connecticut
2020-04-18,DC,2666,10602,13268,11,District of Columbia
2020-04-18,DE,2323,11694,14017,10,Delaware
2020-04-18,FL,25269,221258,246527,12,Florida
2020-04-18,GA,17669,56539,74208,13,Georgia
2020-04-18,GU,133,943,1076,66,Guam
2020-04-18,HI,553,21790,22343,15,Hawaii
2020-04-18,IA,2513,20434,22947,19,Iowa
2020-04-18,ID,1655,15292,16947,16,Idaho
2020-04-18,IL,29160,108244,137404,17,Illinois
2020-04-18,IN,10641,46232,56873,18,Indiana
2020-04-18,KS,1790,15886,17676,20,Kansas
2020-04-18,KY,2522,28074,30596,21,Kentucky
2020-04-18,LA,23580,114419,137999,22,Louisiana
2020-04-18,MA,37527,124604,162131,25,Massachusetts
2020-04-18,MD,12308,53062,65370,24,Maryland
2020-04-18,ME,847,14076,14923,23,Maine
2020-04-18,MI,37029,87114,124143,26,Michigan
2020-04-18,MN,2788,45182,47970,27,Minnesota
2020-04-18,MO,5517,48242,53759,29,Missouri
2020-04-18,MP,14,42,56,69,Northern Mariana Islands
2020-04-18,MS,3974,34791,38765,28,Mississippi
2020-04-18,MT,426,10143,10569,30,Montana
2020-04-18,NC,6140,70071,76211,37,North Carolina
2020-04-18,ND,528,12435,12963,38,North Dakota
2020-04-18,NE,1138,12539,13677,31,Nebraska
2020-04-18,NH,1287,11565,12852,33,New Hampshire
2020-04-18,NJ,81420,81116,162536,34,New Jersey
2020-04-18,NM,1711,33902,35613,35,New Mexico
2020-04-18,NV,3626,27125,30751,32,Nevada
2020-04-18,NY,236732,359800,596532,36,New York
2020-04-18,OH,10222,68819,79041,39,Ohio
2020-04-18,OK,2570,32966,35536,40,Oklahoma
2020-04-18,OR,1844,35739,37583,41,Oregon
2020-04-18,PA,31069,122896,153965,42,Pennsylvania
2020-04-18,PR,1118,8055,9173,72,Puerto Rico
2020-04-18,RI,4868,27527,32395,44,Rhode Island
2020-04-18,SC,4246,34587,38833,45,South Carolina
2020-04-18,SD,1542,10118,11660,46,South Dakota
2020-04-18,TN,6762,83824,90586,47,Tennessee
2020-04-18,TX,18260,157979,176239,48,Texas
2020-04-18,UT,2931,57013,59944,49,Utah
2020-04-18,VA,8053,43878,51931,51,Virginia
2020-04-18,VI,53,390,443,78,U.S. Virgin Islands
2020-04-18,VT,813,11212,12025,50,Vermont
2020-04-18,WA,13407,142307,155714,53,Washington
2020-04-18,WI,5013,43962,48975,55,Wisconsin
2020-04-18,WV,785,18655,19440,54,West Virginia
2020-04-18,WY,305,6217,6522,56,Wyoming
2020-04-17,AK,309,9141,9450,02,Alaska
2020-04-17,AL,4530,33318,37848,01,Alabama
2020-04-17,AR,1695,21799,23494,05,Arkansas
2020-04-17,AS,0,3,3,60,American Samoa
2020-04-17,AZ,4507,44723,49230,04,Arizona
2020-04-17,CA,27528,224086,251614,06,California
2020-04-17,CO,8675,33155,41830,08,Colorado
2020-04-17,CT,16809,38653,55462,09,Connecticut
2020-04-17,DC,2476,10167,12643,11,District of Columbia
2020-04-17,DE,2323,11694,14017,10,Delaware
2020-04-17,FL,24119,210718,234837,12,Florida
2020-04-17,GA,17194,54490,71684,13,Georgia
2020-04-17,GU,133,940,1073,66,Guam
2020-04-17,HI,541,21316,21857,15,Hawaii
2020-04-17,IA,2332,19460,21792,19,Iowa
2020-04-17,ID,1609,15043,16652,16,Idaho
2020-04-17,IL,27575,102588,130163,17,Illinois
2020-04-17,IN,10154,44631,54785,18,Indiana
2020-04-17,KS,1705,15196,16901,20,Kansas
2020-04-17,KY,2429,27318,29747,21,Kentucky
2020-04-17,LA,23118,108869,131987,22,Louisiana
2020-04-17,MA,35125,117195,152320,25,Massachusetts
2020-04-17,MD,11572,50437,62009,24,Maryland
2020-04-17,ME,827,14076,14903,23,Maine
2020-04-17,MI,36320,83268,119588,26,Michigan
2020-04-17,MN,2668,43820,46488,27,Minnesota
2020-04-17,MO,5283,46434,51717,29,Missouri
2020-04-17,MP,13,42,55,69,Northern Mariana Islands
2020-04-17,MS,3793,34791,38584,28,Mississippi
2020-04-17,MT,422,9822,10244,30,Montana
2020-04-17,NC,5859,67122,72981,37,North Carolina
2020-04-17,ND,439,11903,12342,38,North Dakota
2020-04-17,NE,1066,12038,13104,31,Nebraska
2020-04-17,NH,1287,11421,12708,33,New Hampshire
2020-04-17,NJ,78467,78982,157449,34,New Jersey
2020-04-17,NM,1597,32891,34488,35,New Mexico
2020-04-17,NV,3524,26238,29762,32,Nevada
2020-04-17,NY,229642,343581,573223,36,New York
2020-04-17,OH,9107,68819,77926,39,Ohio
2020-04-17,OK,2465,31155,33620,40,Oklahoma
2020-04-17,OR,1785,34536,36321,41,Oregon
2020-04-17,PA,29441,117932,147373,42,Pennsylvania
2020-04-17,PR,1068,7864,8932,72,Puerto Rico
2020-04-17,RI,4585,26157,30742,44,Rhode Island
2020-04-17,SC,3931,32353,36284,45,South Carolina
2020-04-17,SD,1411,9651,11062,46,South Dakota
2020-04-17,TN,6589,80684,87273,47,Tennessee
2020-04-17,TX,17371,152165,169536,48,Texas
2020-04-17,UT,2805,52966,55771,49,Utah
2020-04-17,VA,7491,41506,48997,51,Virginia
2020-04-17,VI,51,373,424,78,U.S. Virgin Islands
2020-04-17,VT,802,10813,11615,50,Vermont
2020-04-17,WA,13174,140294,153468,53,Washington
2020-04-17,WI,4839,42365,47204,55,Wisconsin
2020-04-17,WV,754,17927,18681,54,West Virginia
2020-04-17,WY,296,6131,6427,56,Wyoming
2020-04-16,AK,300,8435,8735,02,Alaska
2020-04-16,AL,4345,32046,36391,01,Alabama
2020-04-16,AR,1620,21055,22675,05,Arkansas
2020-04-16,AS,0,3,3,60,American Samoa
2020-04-16,AZ,4234,43164,47398,04,Arizona
2020-04-16,CA,26182,220218,246400,06,California
2020-04-16,CO,8280,32253,40533,08,Colorado
2020-04-16,CT,15884,37238,53122,09,Connecticut
2020-04-16,DC,2350,9800,12150,11,District of Columbia
2020-04-16,DE,2075,11275,13350,10,Delaware
2020-04-16,FL,22897,196351,219248,12,Florida
2020-04-16,GA,15669,52270,67939,13,Georgia
2020-04-16,GU,133,870,1003,66,Guam
2020-04-16,HI,530,20170,20700,15,Hawaii
2020-04-16,IA,2141,18534,20675,19,Iowa
2020-04-16,ID,1587,14655,16242,16,Idaho
2020-04-16,IL,25733,96856,122589,17,Illinois
2020-04-16,IN,9542,41573,51115,18,Indiana
2020-04-16,KS,1588,14534,16122,20,Kansas
2020-04-16,KY,2291,26033,28324,21,Kentucky
2020-04-16,LA,22532,104054,126586,22,Louisiana
2020-04-16,MA,32492,110098,142590,25,Massachusetts
2020-04-16,MD,10784,48059,58843,24,Maryland
2020-04-16,ME,796,14076,14872,23,Maine
2020-04-16,MI,35455,78274,113729,26,Michigan
2020-04-16,MN,2486,42536,45022,27,Minnesota
2020-04-16,MO,5111,45537,50648,29,Missouri
2020-04-16,MP,13,27,40,69,Northern Mariana Islands
2020-04-16,MS,3624,34791,38415,28,Mississippi
2020-04-16,MT,415,9521,9936,30,Montana
2020-04-16,NC,5465,65452,70917,37,North Carolina
2020-04-16,ND,393,11311,11704,38,North Dakota
2020-04-16,NE,952,11342,12294,31,Nebraska
2020-04-16,NH,1139,11027,12166,33,New Hampshire
2020-04-16,NJ,75317,76513,151830,34,New Jersey
2020-04-16,NM,1484,31910,33394,35,New Mexico
2020-04-16,NV,3321,25130,28451,32,Nevada
2020-04-16,NY,222284,328295,550579,36,New York
2020-04-16,OH,8414,66426,74840,39,Ohio
2020-04-16,OK,2357,28542,30899,40,Oklahoma
2020-04-16,OR,1736,33202,34938,41,Oregon
2020-04-16,PA,27735,113735,141470,42,Pennsylvania
2020-04-16,PR,1043,7315,8358,72,Puerto Rico
2020-04-16,RI,4295,24657,28952,44,Rhode Island
2020-04-16,SC,3656,31077,34733,45,South Carolina
2020-04-16,SD,1311,9239,10550,46,South Dakota
2020-04-16,TN,6262,78787,85049,47,Tennessee
2020-04-16,TX,16455,142092,158547,48,Texas
2020-04-16,UT,2683,46995,49678,49,Utah
2020-04-16,VA,6889,39555,46444,51,Virginia
2020-04-16,VI,51,357,408,78,U.S. Virgin Islands
2020-04-16,VT,792,10259,11051,50,Vermont
2020-04-16,WA,12872,136144,149016,53,Washington
2020-04-16,WI,4636,40974,45610,55,Wisconsin
2020-04-16,WV,739,17567,18306,54,West Virginia
2020-04-16,WY,296,6131,6427,56,Wyoming
2020-04-15,AK,293,8371,8664,02,Alaska
2020-04-15,AL,4113,29964,34077,01,Alabama
2020-04-15,AR,1569,20265,21834,05,Arkansas
2020-04-15,AS,0,3,3,60,American Samoa
2020-04-15,AZ,3962,41348,45310,04,Arizona
2020-04-15,CA,24424,192062,216486,06,California
2020-04-15,CO,7941,31639,39580,08,Colorado
2020-04-15,CT,14755,35388,50143,09,Connecticut
2020-04-15,DC,2197,9328,11525,11,District of Columbia
2020-04-15,DE,2014,11088,13102,10,Delaware
2020-04-15,FL,22511,190998,213509,12,Florida
2020-04-15,GA,14987,49103,64090,13,Georgia
2020-04-15,GU,133,843,976,66,Guam
2020-04-15,HI,517,19286,19803,15,Hawaii
2020-04-15,IA,1995,17874,19869,19,Iowa
2020-04-15,ID,1464,13934,15398,16,Idaho
2020-04-15,IL,24593,92336,116929,17,Illinois
2020-04-15,IN,8955,39441,48396,18,Indiana
2020-04-15,KS,1494,13174,14668,20,Kansas
2020-04-15,KY,2210,25487,27697,21,Kentucky
2020-04-15,LA,21951,99977,121928,22,Louisiana
2020-04-15,MA,29970,102790,132760,25,Massachusetts
2020-04-15,MD,10032,45731,55763,24,Maryland
2020-04-15,ME,770,14076,14846,23,Maine
2020-04-15,MI,34533,73828,108361,26,Michigan
2020-04-15,MN,2321,41245,43566,27,Minnesota
2020-04-15,MO,4895,44117,49012,29,Missouri
2020-04-15,MP,13,27,40,69,Northern Mariana Islands
2020-04-15,MS,3360,34791,38151,28,Mississippi
2020-04-15,MT,404,9179,9583,30,Montana
2020-04-15,NC,5123,62704,67827,37,North Carolina
2020-04-15,ND,365,10952,11317,38,North Dakota
2020-04-15,NE,901,10828,11729,31,Nebraska
2020-04-15,NH,1139,11027,12166,33,New Hampshire
2020-04-15,NJ,71030,72991,144021,34,New Jersey
2020-04-15,NM,1407,31443,32850,35,New Mexico
2020-04-15,NV,3211,24444,27655,32,Nevada
2020-04-15,NY,213779,312233,526012,36,New York
2020-04-15,OH,7791,63761,71552,39,Ohio
2020-04-15,OK,2263,26956,29219,40,Oklahoma
2020-04-15,OR,1663,31688,33351,41,Oregon
2020-04-15,PA,26490,111094,137584,42,Pennsylvania
2020-04-15,PR,974,6825,7799,72,Puerto Rico
2020-04-15,RI,3903,22567,26470,44,Rhode Island
2020-04-15,SC,3656,31077,34733,45,South Carolina
2020-04-15,SD,1168,8691,9859,46,South Dakota
2020-04-15,TN,6079,74817,80896,47,Tennessee
2020-04-15,TX,15492,136318,151810,48,Texas
2020-04-15,UT,2542,45072,47614,49,Utah
2020-04-15,VA,6500,37669,44169,51,Virginia
2020-04-15,VI,51,331,382,78,U.S. Virgin Islands
2020-04-15,VT,779,9913,10692,50,Vermont
2020-04-15,WA,12619,132049,144668,53,Washington
2020-04-15,WI,4453,39326,43779,55,Wisconsin
2020-04-15,WV,702,16954,17656,54,West Virginia
2020-04-15,WY,287,6042,6329,56,Wyoming
2020-04-14,AK,285,8063,8348,02,Alaska
2020-04-14,AL,3876,29241,33117,01,Alabama
2020-04-14,AR,1480,19651,21131,05,Arkansas
2020-04-14,AS,0,3,3,60,American Samoa
2020-04-14,AZ,3806,40290,44096,04,Arizona
2020-04-14,CA,23338,178870,202208,06,California
2020-04-14,CO,7691,31051,38742,08,Colorado
2020-04-14,CT,13989,31852,45841,09,Connecticut
2020-04-14,DC,2058,9226,11284,11,District of Columbia
2020-04-14,DE,1761,10543,12304,10,Delaware
2020-04-14,FL,21367,181813,203180,12,Florida
2020-04-14,GA,14223,47572,61795,13,Georgia
2020-04-14,GU,133,811,944,66,Guam
2020-04-14,HI,504,18916,19420,15,Hawaii
2020-04-14,IA,1899,16986,18885,19,Iowa
2020-04-14,ID,1453,13661,15114,16,Idaho
2020-04-14,IL,23247,87369,110616,17,Illinois
2020-04-14,IN,8527,37490,46017,18,Indiana
2020-04-14,KS,1426,12721,14147,20,Kansas
2020-04-14,KY,2048,24635,26683,21,Kentucky
2020-04-14,LA,21518,96904,118422,22,Louisiana
2020-04-14,MA,28109,98820,126929,25,Massachusetts
2020-04-14,MD,9472,44261,53733,24,Maryland
2020-04-14,ME,734,11608,12342,23,Maine
2020-04-14,MI,33613,70675,104288,26,Michigan
2020-04-14,MN,2165,39705,41870,27,Minnesota
2020-04-14,MO,4686,43292,47978,29,Missouri
2020-04-14,MP,13,27,40,69,Northern Mariana Islands
2020-04-14,MS,3087,34791,37878,28,Mississippi
2020-04-14,MT,399,8835,9234,30,Montana
2020-04-14,NC,5024,60015,65039,37,North Carolina
2020-04-14,ND,341,10575,10916,38,North Dakota
2020-04-14,NE,871,10486,11357,31,Nebraska
2020-04-14,NH,1020,10590,11610,33,New Hampshire
2020-04-14,NJ,68824,70950,139774,34,New Jersey
2020-04-14,NM,1345,30625,31970,35,New Mexico
2020-04-14,NV,3088,23573,26661,32,Nevada
2020-04-14,NY,202208,296935,499143,36,New York
2020-04-14,OH,7280,60721,68001,39,Ohio
2020-04-14,OK,2184,26085,28269,40,Oklahoma
2020-04-14,OR,1633,30730,32363,41,Oregon
2020-04-14,PA,25345,108286,133631,42,Pennsylvania
2020-04-14,PR,923,6284,7207,72,Puerto Rico
2020-04-14,RI,3596,20990,24586,44,Rhode Island
2020-04-14,SC,3553,30319,33872,45,South Carolina
2020-04-14,SD,988,8308,9296,46,South Dakota
2020-04-14,TN,5823,73008,78831,47,Tennessee
2020-04-14,TX,14624,131843,146467,48,Texas
2020-04-14,UT,2412,44064,46476,49,Utah
2020-04-14,VA,6171,36592,42763,51,Virginia
2020-04-14,VI,51,326,377,78,U.S. Virgin Islands
2020-04-14,VT,770,9491,10261,50,Vermont
2020-04-14,WA,12303,128219,140522,53,Washington
2020-04-14,WI,4246,37997,42243,55,Wisconsin
2020-04-14,WV,640,16398,17038,54,West Virginia
2020-04-14,WY,275,5689,5964,56,Wyoming
2020-04-13,AK,277,7553,7830,02,Alaska
2020-04-13,AL,3734,25448,29182,01,Alabama
2020-04-13,AR,1410,19394,20804,05,Arkansas
2020-04-13,AS,0,3,3,60,American Samoa
2020-04-13,AZ,3702,39645,43347,04,Arizona
2020-04-13,CA,22348,168534,190882,06,California
2020-04-13,CO,7684,29850,37534,08,Colorado
2020-04-13,CT,13381,30928,44309,09,Connecticut
2020-04-13,DC,1955,8979,10934,11,District of Columbia
2020-04-13,DE,1625,10195,11820,10,Delaware
2020-04-13,FL,20601,175606,196207,12,Florida
2020-04-13,GA,13315,43706,57021,13,Georgia
2020-04-13,GU,133,770,903,66,Guam
2020-04-13,HI,499,18345,18844,15,Hawaii
2020-04-13,IA,1710,16986,18696,19,Iowa
2020-04-13,ID,1426,13455,14881,16,Idaho
2020-04-13,IL,22025,83743,105768,17,Illinois
2020-04-13,IN,8236,36303,44539,18,Indiana
2020-04-13,KS,1376,12488,13864,20,Kansas
2020-04-13,KY,1963,23903,25866,21,Kentucky
2020-04-13,LA,21016,87075,108091,22,Louisiana
2020-04-13,MA,26794,95500,122294,25,Massachusetts
2020-04-13,MD,8936,42815,51751,24,Maryland
2020-04-13,ME,698,11608,12306,23,Maine
2020-04-13,MI,32702,67063,99765,26,Michigan
2020-04-13,MN,2012,38667,40679,27,Minnesota
2020-04-13,MO,4388,41040,45428,29,Missouri
2020-04-13,MP,11,27,38,69,Northern Mariana Islands
2020-04-13,MS,2942,28042,30984,28,Mississippi
2020-04-13,MT,394,8704,9098,30,Montana
2020-04-13,NC,4816,58572,63388,37,North Carolina
2020-04-13,ND,331,10450,10781,38,North Dakota
2020-04-13,NE,814,10158,10972,31,Nebraska
2020-04-13,NH,985,10222,11207,33,New Hampshire
2020-04-13,NJ,64584,64885,129469,34,New Jersey
2020-04-13,NM,1245,29270,30515,35,New Mexico
2020-04-13,NV,2971,22493,25464,32,Nevada
2020-04-13,NY,195031,283326,478357,36,New York
2020-04-13,OH,6975,58137,65112,39,Ohio
2020-04-13,OK,2069,20790,22859,40,Oklahoma
2020-04-13,OR,1584,29537,31121,41,Oregon
2020-04-13,PA,24199,105593,129792,42,Pennsylvania
2020-04-13,PR,903,5960,6863,72,Puerto Rico
2020-04-13,RI,3329,19431,22760,44,Rhode Island
2020-04-13,SC,3319,28106,31425,45,South Carolina
2020-04-13,SD,868,8134,9002,46,South Dakota
2020-04-13,TN,5610,70585,76195,47,Tennessee
2020-04-13,TX,13906,119320,133226,48,Texas
2020-04-13,UT,2363,43424,45787,49,Utah
2020-04-13,VA,5747,35654,41401,51,Virginia
2020-04-13,VI,51,322,373,78,U.S. Virgin Islands
2020-04-13,VT,761,9275,10036,50,Vermont
2020-04-13,WA,12079,124134,136213,53,Washington
2020-04-13,WI,4080,36769,40849,55,Wisconsin
2020-04-13,WV,626,16029,16655,54,West Virginia
2020-04-13,WY,275,5689,5964,56,Wyoming
2020-04-12,AK,272,7766,8038,02,Alaska
2020-04-12,AL,3525,18058,21583,01,Alabama
2020-04-12,AR,1280,18442,19722,05,Arkansas
2020-04-12,AS,0,3,3,60,American Samoa
2020-04-12,AZ,3539,38570,42109,04,Arizona
2020-04-12,CA,21794,168534,190328,06,California
2020-04-12,CO,6893,27980,34873,08,Colorado
2020-04-12,CT,12035,29185,41220,09,Connecticut
2020-04-12,DC,1875,8765,10640,11,District of Columbia
2020-04-12,DE,1479,9624,11103,10,Delaware
2020-04-12,FL,19355,163398,182753,12,Florida
2020-04-12,GA,12452,42001,54453,13,Georgia
2020-04-12,GU,133,693,826,66,Guam
2020-04-12,HI,486,17482,17968,15,Hawaii
2020-04-12,IA,1587,16005,17592,19,Iowa
2020-04-12,ID,1407,12901,14308,16,Idaho
2020-04-12,IL,20852,79883,100735,17,Illinois
2020-04-12,IN,7928,34561,42489,18,Indiana
2020-04-12,KS,1337,11916,13253,20,Kansas
2020-04-12,KY,1840,22727,24567,21,Kentucky
2020-04-12,LA,20595,83450,104045,22,Louisiana
2020-04-12,MA,25381,91463,116844,25,Massachusetts
2020-04-12,MD,8225,41539,49764,24,Maryland
2020-04-12,ME,633,6088,6721,23,Maine
2020-04-12,MI,31666,64555,96221,26,Michigan
2020-04-12,MN,1864,38030,39894,27,Minnesota
2020-04-12,MO,4160,41040,45200,29,Missouri
2020-04-12,MP,11,27,38,69,Northern Mariana Islands
2020-04-12,MS,2781,18632,21413,28,Mississippi
2020-04-12,MT,387,8526,8913,30,Montana
2020-04-12,NC,4520,57619,62139,37,North Carolina
2020-04-12,ND,308,10042,10350,38,North Dakota
2020-04-12,NE,791,9900,10691,31,Nebraska
2020-04-12,NH,929,9996,10925,33,New Hampshire
2020-04-12,NJ,61850,64885,126735,34,New Jersey
2020-04-12,NM,1174,27518,28692,35,New Mexico
2020-04-12,NV,2836,21775,24611,32,Nevada
2020-04-12,NY,188694,272907,461601,36,New York
2020-04-12,OH,6604,56639,63243,39,Ohio
2020-04-12,OK,1970,20790,22760,40,Oklahoma
2020-04-12,OR,1527,28231,29758,41,Oregon
2020-04-12,PA,22833,102057,124890,42,Pennsylvania
2020-04-12,PR,897,5819,6716,72,Puerto Rico
2020-04-12,RI,3142,18578,21720,44,Rhode Island
2020-04-12,SC,3319,28106,31425,45,South Carolina
2020-04-12,SD,730,7823,8553,46,South Dakota
2020-04-12,TN,5308,65369,70677,47,Tennessee
2020-04-12,TX,13484,111049,124533,48,Texas
2020-04-12,UT,2303,41931,44234,49,Utah
2020-04-12,VA,5274,34711,39985,51,Virginia
2020-04-12,VI,51,299,350,78,U.S. Virgin Islands
2020-04-12,VT,754,8724,9478,50,Vermont
2020-04-12,WA,11775,120218,131993,53,Washington
2020-04-12,WI,3964,35916,39880,55,Wisconsin
2020-04-12,WV,611,15646,16257,54,West Virginia
2020-04-12,WY,261,5198,5459,56,Wyoming
2020-04-11,AK,257,7475,7732,02,Alaska
2020-04-11,AL,3191,18058,21249,01,Alabama
2020-04-11,AR,1226,17352,18578,05,Arkansas
2020-04-11,AS,0,3,3,60,American Samoa
2020-04-11,AZ,3393,37137,40530,04,Arizona
2020-04-11,CA,20615,152604,173219,06,California
2020-04-11,CO,6510,26143,32653,08,Colorado
2020-04-11,CT,11510,28321,39831,09,Connecticut
2020-04-11,DC,1778,8261,10039,11,District of Columbia
2020-04-11,DE,1479,9624,11103,10,Delaware
2020-04-11,FL,18494,154439,172933,12,Florida
2020-04-11,GA,12159,39556,51715,13,Georgia
2020-04-11,GU,133,693,826,66,Guam
2020-04-11,HI,465,17066,17531,15,Hawaii
2020-04-11,IA,1510,15622,17132,19,Iowa
2020-04-11,ID,1396,12368,13764,16,Idaho
2020-04-11,IL,19180,72969,92149,17,Illinois
2020-04-11,IN,7435,31780,39215,18,Indiana
2020-04-11,KS,1268,11075,12343,20,Kansas
2020-04-11,KY,1693,22595,24288,21,Kentucky
2020-04-11,LA,20014,76901,96915,22,Louisiana
2020-04-11,MA,22766,86115,108881,25,Massachusetts
2020-04-11,MD,7694,39544,47238,24,Maryland
2020-04-11,ME,616,6088,6704,23,Maine
2020-04-11,MI,30980,62241,93221,26,Michigan
2020-04-11,MN,1806,36898,38704,27,Minnesota
2020-04-11,MO,4024,39148,43172,29,Missouri
2020-04-11,MP,11,27,38,69,Northern Mariana Islands
2020-04-11,MS,2642,18632,21274,28,Mississippi
2020-04-11,MT,377,8204,8581,30,Montana
2020-04-11,NC,4312,56081,60393,37,North Carolina
2020-04-11,ND,293,9787,10080,38,North Dakota
2020-04-11,NE,700,9285,9985,31,Nebraska
2020-04-11,NH,885,9608,10493,33,New Hampshire
2020-04-11,NJ,58151,62042,120193,34,New Jersey
2020-04-11,NM,1091,26007,27098,35,New Mexico
2020-04-11,NV,2700,20887,23587,32,Nevada
2020-04-11,NY,180458,260522,440980,36,New York
2020-04-11,OH,6250,54221,60471,39,Ohio
2020-04-11,OK,1868,20790,22658,40,Oklahoma
2020-04-11,OR,1371,25853,27224,41,Oregon
2020-04-11,PA,21655,98498,120153,42,Pennsylvania
2020-04-11,PR,788,5583,6371,72,Puerto Rico
2020-04-11,RI,2853,17130,19983,44,Rhode Island
2020-04-11,SC,3207,26886,30093,45,South Carolina
2020-04-11,SD,626,7378,8004,46,South Dakota
2020-04-11,TN,5114,61714,66828,47,Tennessee
2020-04-11,TX,12561,107972,120533,48,Texas
2020-04-11,UT,2206,40340,42546,49,Utah
2020-04-11,VA,5077,32922,37999,51,Virginia
2020-04-11,VI,51,299,350,78,U.S. Virgin Islands
2020-04-11,VT,733,8063,8796,50,Vermont
2020-04-11,WA,11605,118957,130562,53,Washington
2020-04-11,WI,3822,34680,38502,55,Wisconsin
2020-04-11,WV,577,14875,15452,54,West Virginia
2020-04-11,WY,261,5198,5459,56,Wyoming
2020-04-10,AK,246,7186,7432,02,Alaska
2020-04-10,AL,2968,18058,21026,01,Alabama
2020-04-10,AR,1171,15949,17120,05,Arkansas
2020-04-10,AS,0,3,3,60,American Samoa
2020-04-10,AZ,3112,34622,37734,04,Arizona
2020-04-10,CA,19472,145391,164863,06,California
2020-04-10,CO,6510,26143,32653,08,Colorado
2020-04-10,CT,10538,25750,36288,09,Connecticut
2020-04-10,DC,1660,7695,9355,11,District of Columbia
2020-04-10,DE,1326,10415,11741,10,Delaware
2020-04-10,FL,17531,145299,162830,12,Florida
2020-04-10,GA,11483,34664,46147,13,Georgia
2020-04-10,GU,130,662,792,66,Guam
2020-04-10,HI,442,15707,16149,15,Hawaii
2020-04-10,IA,1388,14565,15953,19,Iowa
2020-04-10,ID,1353,11741,13094,16,Idaho
2020-04-10,IL,17887,69640,87527,17,Illinois
2020-04-10,IN,6907,28133,35040,18,Indiana
2020-04-10,KS,1166,10248,11414,20,Kansas
2020-04-10,KY,1693,22595,24288,21,Kentucky
2020-04-10,LA,19253,73027,92280,22,Louisiana
2020-04-10,MA,20878,81564,102442,25,Massachusetts
2020-04-10,MD,6968,37480,44448,24,Maryland
2020-04-10,ME,586,6088,6674,23,Maine
2020-04-10,MI,30172,59597,89769,26,Michigan
2020-04-10,MN,1732,35346,37078,27,Minnesota
2020-04-10,MO,3799,36941,40740,29,Missouri
2020-04-10,MP,11,27,38,69,Northern Mariana Islands
2020-04-10,MS,2469,18632,21101,28,Mississippi
2020-04-10,MT,365,7932,8297,30,Montana
2020-04-10,NC,3908,53737,57645,37,North Carolina
2020-04-10,ND,278,9330,9608,38,North Dakota
2020-04-10,NE,635,8719,9354,31,Nebraska
2020-04-10,NH,819,9139,9958,33,New Hampshire
2020-04-10,NJ,54588,58935,113523,34,New Jersey
2020-04-10,NM,1091,26007,27098,35,New Mexico
2020-04-10,NV,2584,20165,22749,32,Nevada
2020-04-10,NY,170512,247373,417885,36,New York
2020-04-10,OH,5878,52695,58573,39,Ohio
2020-04-10,OK,1794,20370,22164,40,Oklahoma
2020-04-10,OR,1321,24306,25627,41,Oregon
2020-04-10,PA,19979,93040,113019,42,Pennsylvania
2020-04-10,PR,725,5121,5846,72,Puerto Rico
2020-04-10,RI,2573,15403,17976,44,Rhode Island
2020-04-10,SC,3065,25118,28183,45,South Carolina
2020-04-10,SD,536,7111,7647,46,South Dakota
2020-04-10,TN,4862,57937,62799,47,Tennessee
2020-04-10,TX,11671,104047,115718,48,Texas
2020-04-10,UT,2102,38660,40762,49,Utah
2020-04-10,VA,4509,30950,35459,51,Virginia
2020-04-10,VI,50,273,323,78,U.S. Virgin Islands
2020-04-10,VT,713,7502,8215,50,Vermont
2020-04-10,WA,11395,117091,128486,53,Washington
2020-04-10,WI,3665,33225,36890,55,Wisconsin
2020-04-10,WV,554,14001,14555,54,West Virginia
2020-04-10,WY,253,4736,4989,56,Wyoming
2020-04-09,AK,235,6988,7223,02,Alaska
2020-04-09,AL,2769,18058,20827,01,Alabama
2020-04-09,AR,1119,13832,14951,05,Arkansas
2020-04-09,AS,0,3,3,60,American Samoa
2020-04-09,AZ,3018,34160,37178,04,Arizona
2020-04-09,CA,18309,145191,163500,06,California
2020-04-09,CO,5655,23544,29199,08,Colorado
2020-04-09,CT,9784,23718,33502,09,Connecticut
2020-04-09,DC,1523,7201,8724,11,District of Columbia
2020-04-09,DE,1207,8683,9890,10,Delaware
2020-04-09,FL,16364,136185,152549,12,Florida
2020-04-09,GA,10566,30519,41085,13,Georgia
2020-04-09,GU,128,593,721,66,Guam
2020-04-09,HI,435,15316,15751,15,Hawaii
2020-04-09,IA,1270,13703,14973,19,Iowa
2020-04-09,ID,1232,11299,12531,16,Idaho
2020-04-09,IL,16422,64435,80857,17,Illinois
2020-04-09,IN,6351,25782,32133,18,Indiana
2020-04-09,KS,1106,9669,10775,20,Kansas
2020-04-09,KY,1346,20455,21801,21,Kentucky
2020-04-09,LA,18283,68636,86919,22,Louisiana
2020-04-09,MA,18843,76146,94989,25,Massachusetts
2020-04-09,MD,6185,35344,41529,24,Maryland
2020-04-09,ME,560,6088,6648,23,Maine
2020-04-09,MI,29096,56430,85526,26,Michigan
2020-04-09,MN,1637,33682,35319,27,Minnesota
2020-04-09,MO,3539,34955,38494,29,Missouri
2020-04-09,MP,11,27,38,69,Northern Mariana Islands
2020-04-09,MS,2260,18632,20892,28,Mississippi
2020-04-09,MT,354,7506,7860,30,Montana
2020-04-09,NC,3651,44158,47809,37,North Carolina
2020-04-09,ND,269,8721,8990,38,North Dakota
2020-04-09,NE,567,8116,8683,31,Nebraska
2020-04-09,NH,788,8763,9551,33,New Hampshire
2020-04-09,NJ,51027,56165,107192,34,New Jersey
2020-04-09,NM,865,22942,23807,35,New Mexico
2020-04-09,NV,2456,19315,21771,32,Nevada
2020-04-09,NY,159937,231612,391549,36,New York
2020-04-09,OH,5512,50473,55985,39,Ohio
2020-04-09,OK,1684,18595,20279,40,Oklahoma
2020-04-09,OR,1321,24306,25627,41,Oregon
2020-04-09,PA,18228,87374,105602,42,Pennsylvania
2020-04-09,PR,683,4703,5386,72,Puerto Rico
2020-04-09,RI,2169,13029,15198,44,Rhode Island
2020-04-09,SC,2792,24575,27367,45,South Carolina
2020-04-09,SD,447,6700,7147,46,South Dakota
2020-04-09,TN,4634,55215,59849,47,Tennessee
2020-04-09,TX,10230,95904,106134,48,Texas
2020-04-09,UT,1976,36397,38373,49,Utah
2020-04-09,VA,4042,28984,33026,51,Virginia
2020-04-09,VI,46,251,297,78,U.S. Virgin Islands
2020-04-09,VT,680,7218,7898,50,Vermont
2020-04-09,WA,11118,113069,124187,53,Washington
2020-04-09,WI,3443,31424,34867,55,Wisconsin
2020-04-09,WV,523,13340,13863,54,West Virginia
2020-04-09,WY,230,3920,4150,56,Wyoming
2020-04-08,AK,226,6842,7068,02,Alaska
2020-04-08,AL,2369,16753,19122,01,Alabama
2020-04-08,AR,1000,13530,14530,05,Arkansas
2020-04-08,AS,0,3,3,60,American Samoa
2020-04-08,AZ,2726,31838,34564,04,Arizona
2020-04-08,CA,16957,127307,144264,06,California
2020-04-08,CO,5429,22665,28094,08,Colorado
2020-04-08,CT,7781,21255,29036,09,Connecticut
2020-04-08,DC,1440,6843,8283,11,District of Columbia
2020-04-08,DE,928,7628,8556,10,Delaware
2020-04-08,FL,15455,127679,143134,12,Florida
2020-04-08,GA,9901,28886,38787,13,Georgia
2020-04-08,GU,125,562,687,66,Guam
2020-04-08,HI,410,14739,15149,15,Hawaii
2020-04-08,IA,1145,12821,13966,19,Iowa
2020-04-08,ID,1210,10688,11898,16,Idaho
2020-04-08,IL,15078,59988,75066,17,Illinois
2020-04-08,IN,5943,24926,30869,18,Indiana
2020-04-08,KS,1046,9137,10183,20,Kansas
2020-04-08,KY,1149,20455,21604,21,Kentucky
2020-04-08,LA,17030,64376,81406,22,Louisiana
2020-04-08,MA,16692,70849,87541,25,Massachusetts
2020-04-08,MD,5529,32933,38462,24,Maryland
2020-04-08,ME,537,6088,6625,23,Maine
2020-04-08,MI,28064,53176,81240,26,Michigan
2020-04-08,MN,1534,31954,33488,27,Minnesota
2020-04-08,MO,3327,30783,34110,29,Missouri
2020-04-08,MP,11,27,38,69,Northern Mariana Islands
2020-04-08,MS,2003,18632,20635,28,Mississippi
2020-04-08,MT,332,7066,7398,30,Montana
2020-04-08,NC,3426,39561,42987,37,North Carolina
2020-04-08,ND,251,8301,8552,38,North Dakota
2020-04-08,NE,519,7442,7961,31,Nebraska
2020-04-08,NH,788,8389,9177,33,New Hampshire
2020-04-08,NJ,47437,52979,100416,34,New Jersey
2020-04-08,NM,794,21451,22245,35,New Mexico
2020-04-08,NV,2318,18248,20566,32,Nevada
2020-04-08,NY,149316,215837,365153,36,New York
2020-04-08,OH,5148,48193,53341,39,Ohio
2020-04-08,OK,1524,11821,13345,40,Oklahoma
2020-04-08,OR,1239,23325,24564,41,Oregon
2020-04-08,PA,16239,82299,98538,42,Pennsylvania
2020-04-08,PR,620,4266,4886,72,Puerto Rico
2020-04-08,RI,1890,11667,13557,44,Rhode Island
2020-04-08,SC,2552,22082,24634,45,South Carolina
2020-04-08,SD,393,6355,6748,46,South Dakota
2020-04-08,TN,4362,52256,56618,47,Tennessee
2020-04-08,TX,9353,86905,96258,48,Texas
2020-04-08,UT,1846,34270,36116,49,Utah
2020-04-08,VA,3645,27000,30645,51,Virginia
2020-04-08,VI,45,242,287,78,U.S. Virgin Islands
2020-04-08,VT,631,7001,7632,50,Vermont
2020-04-08,WA,10831,109050,119881,53,Washington
2020-04-08,WI,3279,30115,33394,55,Wisconsin
2020-04-08,WV,462,12083,12545,54,West Virginia
2020-04-08,WY,221,3843,4064,56,Wyoming
2020-04-07,AK,213,6700,6913,02,Alaska
2020-04-07,AL,2119,12797,14916,01,Alabama
2020-04-07,AR,946,12692,13638,05,Arkansas
2020-04-07,AS,0,3,3,60,American Samoa
2020-04-07,AZ,2575,30800,33375,04,Arizona
2020-04-07,CA,15865,115364,131229,06,California
2020-04-07,CO,5172,21703,26875,08,Colorado
2020-04-07,CT,7781,21255,29036,09,Connecticut
2020-04-07,DC,1211,6612,7823,11,District of Columbia
2020-04-07,DE,928,7628,8556,10,Delaware
2020-04-07,FL,14747,123415,138162,12,Florida
2020-04-07,GA,8818,24895,33713,13,Georgia
2020-04-07,GU,121,529,650,66,Guam
2020-04-07,HI,387,13155,13542,15,Hawaii
2020-04-07,IA,1048,11670,12718,19,Iowa
2020-04-07,ID,1170,10076,11246,16,Idaho
2020-04-07,IL,13549,55183,68732,17,Illinois
2020-04-07,IN,5507,23257,28764,18,Indiana
2020-04-07,KS,900,8614,9514,20,Kansas
2020-04-07,KY,1008,18947,19955,21,Kentucky
2020-04-07,LA,16284,58371,74655,22,Louisiana
2020-04-07,MA,15104,66270,81374,25,Massachusetts
2020-04-07,MD,4371,27256,31627,24,Maryland
2020-04-07,ME,519,6088,6607,23,Maine
2020-04-07,MI,26964,50344,77308,26,Michigan
2020-04-07,MN,1432,30603,32035,27,Minnesota
2020-04-07,MO,3037,28932,31969,29,Missouri
2020-04-07,MP,8,15,23,69,Northern Mariana Islands
2020-04-07,MS,1915,18632,20547,28,Mississippi
2020-04-07,MT,319,6666,6985,30,Montana
2020-04-07,NC,3221,37861,41082,37,North Carolina
2020-04-07,ND,237,7466,7703,38,North Dakota
2020-04-07,NE,447,6811,7258,31,Nebraska
2020-04-07,NH,715,8019,8734,33,New Hampshire
2020-04-07,NJ,44416,50558,94974,34,New Jersey
2020-04-07,NM,686,21139,21825,35,New Mexico
2020-04-07,NV,2087,16552,18639,32,Nevada
2020-04-07,NY,138863,201195,340058,36,New York
2020-04-07,OH,4782,46056,50838,39,Ohio
2020-04-07,OK,1472,11821,13293,40,Oklahoma
2020-04-07,OR,1181,21826,23007,41,Oregon
2020-04-07,PA,14559,76719,91278,42,Pennsylvania
2020-04-07,PR,573,3966,4539,72,Puerto Rico
2020-04-07,RI,1617,10095,11712,44,Rhode Island
2020-04-07,SC,2417,21263,23680,45,South Carolina
2020-04-07,SD,320,5948,6268,46,South Dakota
2020-04-07,TN,4138,48736,52874,47,Tennessee
2020-04-07,TX,8262,80387,88649,48,Texas
2020-04-07,UT,1738,32909,34647,49,Utah
2020-04-07,VA,3333,25312,28645,51,Virginia
2020-04-07,VI,43,222,265,78,U.S. Virgin Islands
2020-04-07,VT,608,6645,7253,50,Vermont
2020-04-07,WA,10547,104530,115077,53,Washington
2020-04-07,WI,3064,28512,31576,55,Wisconsin
2020-04-07,WV,412,11647,12059,54,West Virginia
2020-04-07,WY,216,3789,4005,56,Wyoming
2020-04-06,AK,191,6692,6883,02,Alaska
2020-04-06,AL,1968,12797,14765,01,Alabama
2020-04-06,AR,875,11970,12845,05,Arkansas
2020-04-06,AS,0,3,3,60,American Samoa
2020-04-06,AZ,2456,30078,32534,04,Arizona
2020-04-06,CA,14336,103095,117431,06,California
2020-04-06,CO,4950,20823,25773,08,Colorado
2020-04-06,CT,6906,19780,26686,09,Connecticut
2020-04-06,DC,1097,6356,7453,11,District of Columbia
2020-04-06,DE,673,6321,6994,10,Delaware
2020-04-06,FL,13324,109950,123274,12,Florida
2020-04-06,GA,7314,23960,31274,13,Georgia
2020-04-06,GU,113,505,618,66,Guam
2020-04-06,HI,371,13155,13526,15,Hawaii
2020-04-06,IA,946,10653,11599,19,Iowa
2020-04-06,ID,1101,9894,10995,16,Idaho
2020-04-06,IL,12262,50680,62942,17,Illinois
2020-04-06,IN,4944,21247,26191,18,Indiana
2020-04-06,KS,845,8239,9084,20,Kansas
2020-04-06,KY,955,17812,18767,21,Kentucky
2020-04-06,LA,14867,54299,69166,22,Louisiana
2020-04-06,MA,13739,62720,76459,25,Massachusetts
2020-04-06,MD,4045,25572,29617,24,Maryland
2020-04-06,ME,499,6088,6587,23,Maine
2020-04-06,MI,25785,47262,73047,26,Michigan
2020-04-06,MN,1330,29155,30485,27,Minnesota
2020-04-06,MO,2722,27113,29835,29,Missouri
2020-04-06,MP,8,13,21,69,Northern Mariana Islands
2020-04-06,MS,1738,18632,20370,28,Mississippi
2020-04-06,MT,299,6491,6790,30,Montana
2020-04-06,NC,2870,37856,40726,37,North Carolina
2020-04-06,ND,225,6988,7213,38,North Dakota
2020-04-06,NE,409,6378,6787,31,Nebraska
2020-04-06,NH,669,7701,8370,33,New Hampshire
2020-04-06,NJ,41090,47942,89032,34,New Jersey
2020-04-06,NM,624,18512,19136,35,New Mexico
2020-04-06,NV,1953,15676,17629,32,Nevada
2020-04-06,NY,130689,190122,320811,36,New York
2020-04-06,OH,4450,43928,48378,39,Ohio
2020-04-06,OK,1327,1422,2749,40,Oklahoma
2020-04-06,OR,1132,20669,21801,41,Oregon
2020-04-06,PA,12980,70874,83854,42,Pennsylvania
2020-04-06,PR,513,3432,3945,72,Puerto Rico
2020-04-06,RI,1356,8609,9965,44,Rhode Island
2020-04-06,SC,2049,16927,18976,45,South Carolina
2020-04-06,SD,288,5732,6020,46,South Dakota
2020-04-06,TN,3802,43548,47350,47,Tennessee
2020-04-06,TX,7276,78081,85357,48,Texas
2020-04-06,UT,1675,31719,33394,49,Utah
2020-04-06,VA,2878,21643,24521,51,Virginia
2020-04-06,VI,43,222,265,78,U.S. Virgin Islands
2020-04-06,VT,575,6161,6736,50,Vermont
2020-04-06,WA,10282,99566,109848,53,Washington
2020-04-06,WI,2866,26574,29440,55,Wisconsin
2020-04-06,WV,345,9595,9940,54,West Virginia
2020-04-06,WY,210,3719,3929,56,Wyoming
2020-04-05,AK,185,6099,6284,02,Alaska
2020-04-05,AL,1796,11282,13078,01,Alabama
2020-04-05,AR,830,10412,11242,05,Arkansas
2020-04-05,AS,0,3,3,60,American Samoa
2020-04-05,AZ,2269,25141,27410,04,Arizona
2020-04-05,CA,13438,103095,116533,06,California
2020-04-05,CO,4565,19335,23900,08,Colorado
2020-04-05,CT,5675,17595,23270,09,Connecticut
2020-04-05,DC,998,5836,6834,11,District of Columbia
2020-04-05,DE,673,6321,6994,10,Delaware
2020-04-05,FL,12151,101253,113404,12,Florida
2020-04-05,GA,6647,21185,27832,13,Georgia
2020-04-05,GU,112,493,605,66,Guam
2020-04-05,HI,351,12604,12955,15,Hawaii
2020-04-05,IA,868,9973,10841,19,Iowa
2020-04-05,ID,1077,9184,10261,16,Idaho
2020-04-05,IL,11256,47727,58983,17,Illinois
2020-04-05,IN,4411,18241,22652,18,Indiana
2020-04-05,KS,747,7476,8223,20,Kansas
2020-04-05,KY,917,15746,16663,21,Kentucky
2020-04-05,LA,13010,47315,60325,22,Louisiana
2020-04-05,MA,12402,59565,71967,25,Massachusetts
2020-04-05,MD,3609,24728,28337,24,Maryland
2020-04-05,ME,470,6088,6558,23,Maine
2020-04-05,MI,24458,44154,68612,26,Michigan
2020-04-05,MN,1217,28090,29307,27,Minnesota
2020-04-05,MO,2367,24882,27249,29,Missouri
2020-04-05,MP,8,13,21,69,Northern Mariana Islands
2020-04-05,MS,1638,5580,7218,28,Mississippi
2020-04-05,MT,286,6317,6603,30,Montana
2020-04-05,NC,2585,37460,40045,37,North Carolina
2020-04-05,ND,207,6580,6787,38,North Dakota
2020-04-05,NE,363,5558,5921,31,Nebraska
2020-04-05,NH,621,7411,8032,33,New Hampshire
2020-04-05,NJ,37505,44661,82166,34,New Jersey
2020-04-05,NM,543,16285,16828,35,New Mexico
2020-04-05,NV,1836,14995,16831,32,Nevada
2020-04-05,NY,122031,180249,302280,36,New York
2020-04-05,OH,4043,39713,43756,39,Ohio
2020-04-05,OK,1252,1401,2653,40,Oklahoma
2020-04-05,OR,1068,19556,20624,41,Oregon
2020-04-05,PA,11510,66261,77771,42,Pennsylvania
2020-04-05,PR,475,3073,3548,72,Puerto Rico
2020-04-05,RI,1150,7032,8182,44,Rhode Island
2020-04-05,SC,2049,16927,18976,45,South Carolina
2020-04-05,SD,240,5353,5593,46,South Dakota
2020-04-05,TN,3633,41667,45300,47,Tennessee
2020-04-05,TX,6812,64126,70938,48,Texas
2020-04-05,UT,1605,29287,30892,49,Utah
2020-04-05,VA,2637,21034,23671,51,Virginia
2020-04-05,VI,42,206,248,78,U.S. Virgin Islands
2020-04-05,VT,543,5830,6373,50,Vermont
2020-04-05,WA,9953,94759,104712,53,Washington
2020-04-05,WI,2643,25169,27812,55,Wisconsin
2020-04-05,WV,324,8514,8838,54,West Virginia
2020-04-05,WY,197,3040,3237,56,Wyoming
2020-04-04,AK,171,5869,6040,02,Alaska
2020-04-04,AL,1580,9273,10853,01,Alabama
2020-04-04,AR,743,9627,10370,05,Arkansas
2020-04-04,AS,0,3,3,60,American Samoa
2020-04-04,AZ,2019,25141,27160,04,Arizona
2020-04-04,CA,12026,101674,113700,06,California
2020-04-04,CO,4173,17898,22071,08,Colorado
2020-04-04,CT,5276,16753,22029,09,Connecticut
2020-04-04,DC,902,5536,6438,11,District of Columbia
2020-04-04,DE,593,5874,6467,10,Delaware
2020-04-04,FL,11111,90956,102067,12,Florida
2020-04-04,GA,6160,20134,26294,13,Georgia
2020-04-04,GU,93,472,565,66,Guam
2020-04-04,HI,319,11959,12278,15,Hawaii
2020-04-04,IA,786,9454,10240,19,Iowa
2020-04-04,ID,1013,7857,8870,16,Idaho
2020-04-04,IL,10357,43224,53581,17,Illinois
2020-04-04,IN,3953,15847,19800,18,Indiana
2020-04-04,KS,698,6880,7578,20,Kansas
2020-04-04,KY,831,14741,15572,21,Kentucky
2020-04-04,LA,12496,46002,58498,22,Louisiana
2020-04-04,MA,11637,57191,68828,25,Massachusetts
2020-04-04,MD,3125,22485,25610,24,Maryland
2020-04-04,ME,456,6088,6544,23,Maine
2020-04-04,MI,23581,41205,64786,26,Michigan
2020-04-04,MN,1158,26687,27845,27,Minnesota
2020-04-04,MO,2291,22614,24905,29,Missouri
2020-04-04,MP,8,13,21,69,Northern Mariana Islands
2020-04-04,MS,1455,5133,6588,28,Mississippi
2020-04-04,MT,265,5912,6177,30,Montana
2020-04-04,NC,2402,36371,38773,37,North Carolina
2020-04-04,ND,186,6021,6207,38,North Dakota
2020-04-04,NE,321,5058,5379,31,Nebraska
2020-04-04,NH,540,6965,7505,33,New Hampshire
2020-04-04,NJ,34124,41232,75356,34,New Jersey
2020-04-04,NM,495,15137,15632,35,New Mexico
2020-04-04,NV,1742,14421,16163,32,Nevada
2020-04-04,NY,113704,169917,283621,36,New York
2020-04-04,OH,3739,38132,41871,39,Ohio
2020-04-04,OK,1159,1362,2521,40,Oklahoma
2020-04-04,OR,999,16535,17534,41,Oregon
2020-04-04,PA,10017,60013,70030,42,Pennsylvania
2020-04-04,PR,452,2605,3057,72,Puerto Rico
2020-04-04,RI,968,5962,6930,44,Rhode Island
2020-04-04,SC,1917,16397,18314,45,South Carolina
2020-04-04,SD,212,5012,5224,46,South Dakota
2020-04-04,TN,3321,38070,41391,47,Tennessee
2020-04-04,TX,6110,57641,63751,48,Texas
2020-04-04,UT,1428,26615,28043,49,Utah
2020-04-04,VA,2407,19145,21552,51,Virginia
2020-04-04,VI,40,184,224,78,U.S. Virgin Islands
2020-04-04,VT,512,5242,5754,50,Vermont
2020-04-04,WA,9732,93028,102760,53,Washington
2020-04-04,WI,2476,23859,26335,55,Wisconsin
2020-04-04,WV,282,7404,7686,54,West Virginia
2020-04-04,WY,187,2945,3132,56,Wyoming
2020-04-03,AK,157,5859,6016,02,Alaska
2020-04-03,AL,1432,8187,9619,01,Alabama
2020-04-03,AR,704,8995,9699,05,Arkansas
2020-04-03,AS,0,3,3,60,American Samoa
2020-04-03,AZ,1769,22904,24673,04,Arizona
2020-04-03,CA,10701,24599,35300,06,California
2020-04-03,CO,3728,16683,20411,08,Colorado
2020-04-03,CT,4914,15101,20015,09,Connecticut
2020-04-03,DC,757,4827,5584,11,District of Columbia
2020-04-03,DE,450,4995,5445,10,Delaware
2020-04-03,FL,9585,82137,91722,12,Florida
2020-04-03,GA,5831,19434,25265,13,Georgia
2020-04-03,GU,84,459,543,66,Guam
2020-04-03,HI,285,10206,10491,15,Hawaii
2020-04-03,IA,699,8754,9453,19,Iowa
2020-04-03,ID,891,7054,7945,16,Idaho
2020-04-03,IL,8904,39144,48048,17,Illinois
2020-04-03,IN,3437,14398,17835,18,Indiana
2020-04-03,KS,620,6454,7074,20,Kansas
2020-04-03,KY,770,12034,12804,21,Kentucky
2020-04-03,LA,10297,43348,53645,22,Louisiana
2020-04-03,MA,10303,52685,62988,25,Massachusetts
2020-04-03,MD,2758,20932,23690,24,Maryland
2020-04-03,ME,432,6088,6520,23,Maine
2020-04-03,MI,22579,37060,59639,26,Michigan
2020-04-03,MN,1119,25063,26182,27,Minnesota
2020-04-03,MO,2113,19357,21470,29,Missouri
2020-04-03,MP,8,13,21,69,Northern Mariana Islands
2020-04-03,MS,1358,4753,6111,28,Mississippi
2020-04-03,MT,243,5333,5576,30,Montana
2020-04-03,NC,2093,29505,31598,37,North Carolina
2020-04-03,ND,173,5625,5798,38,North Dakota
2020-04-03,NE,279,4487,4766,31,Nebraska
2020-04-03,NH,479,6575,7054,33,New Hampshire
2020-04-03,NJ,29895,37608,67503,34,New Jersey
2020-04-03,NM,403,14375,14778,35,New Mexico
2020-04-03,NV,1514,13018,14532,32,Nevada
2020-04-03,NY,102863,157657,260520,36,New York
2020-04-03,OH,3312,35063,38375,39,Ohio
2020-04-03,OK,988,1315,2303,40,Oklahoma
2020-04-03,OR,899,16535,17434,41,Oregon
2020-04-03,PA,8420,53695,62115,42,Pennsylvania
2020-04-03,PR,378,2049,2427,72,Puerto Rico
2020-04-03,RI,831,5342,6173,44,Rhode Island
2020-04-03,SC,1554,5441,6995,45,South Carolina
2020-04-03,SD,187,4593,4780,46,South Dakota
2020-04-03,TN,3067,34772,37839,47,Tennessee
2020-04-03,TX,5330,50434,55764,48,Texas
2020-04-03,UT,1246,23002,24248,49,Utah
2020-04-03,VA,2012,16993,19005,51,Virginia
2020-04-03,VI,38,154,192,78,U.S. Virgin Islands
2020-04-03,VT,460,4865,5325,50,Vermont
2020-04-03,WA,9485,90661,100146,53,Washington
2020-04-03,WI,2263,22377,24640,55,Wisconsin
2020-04-03,WV,237,6130,6367,54,West Virginia
2020-04-03,WY,162,2704,2866,56,Wyoming
2020-04-02,AK,143,4879,5022,02,Alaska
2020-04-02,AL,1233,7503,8736,01,Alabama
2020-04-02,AR,643,7880,8523,05,Arkansas
2020-04-02,AS,0,3,3,60,American Samoa
2020-04-02,AZ,1598,21111,22709,04,Arizona
2020-04-02,CA,9191,23809,33000,06,California
2020-04-02,CO,3342,15303,18645,08,Colorado
2020-04-02,CT,3824,14476,18300,09,Connecticut
2020-04-02,DC,653,4417,5070,11,District of Columbia
2020-04-02,DE,393,4566,4959,10,Delaware
2020-04-02,FL,8010,69286,77296,12,Florida
2020-04-02,GA,5348,17609,22957,13,Georgia
2020-04-02,GU,82,442,524,66,Guam
2020-04-02,HI,258,10206,10464,15,Hawaii
2020-04-02,IA,614,8054,8668,19,Iowa
2020-04-02,ID,669,6613,7282,16,Idaho
2020-04-02,IL,7695,35961,43656,17,Illinois
2020-04-02,IN,3039,13246,16285,18,Indiana
2020-04-02,KS,552,6059,6611,20,Kansas
2020-04-02,KY,680,7220,7900,21,Kentucky
2020-04-02,LA,9150,41936,51086,22,Louisiana
2020-04-02,MA,8867,47767,56634,25,Massachusetts
2020-04-02,MD,2331,18890,21221,24,Maryland
2020-04-02,ME,376,6088,6464,23,Maine
2020-04-02,MI,21376,33443,54819,26,Michigan
2020-04-02,MN,1056,23780,24836,27,Minnesota
2020-04-02,MO,1834,17849,19683,29,Missouri
2020-04-02,MP,8,13,21,69,Northern Mariana Islands
2020-04-02,MS,1177,4753,5930,28,Mississippi
2020-04-02,MT,227,5093,5320,30,Montana
2020-04-02,NC,1857,26822,28679,37,North Carolina
2020-04-02,ND,159,4821,4980,38,North Dakota
2020-04-02,NE,246,3978,4224,31,Nebraska
2020-04-02,NH,415,6078,6493,33,New Hampshire
2020-04-02,NJ,25590,33520,59110,34,New Jersey
2020-04-02,NM,363,13648,14011,35,New Mexico
2020-04-02,NV,1458,12588,14046,32,Nevada
2020-04-02,NY,92381,146584,238965,36,New York
2020-04-02,OH,2902,32016,34918,39,Ohio
2020-04-02,OK,879,1265,2144,40,Oklahoma
2020-04-02,OR,826,15259,16085,41,Oregon
2020-04-02,PA,7016,47698,54714,42,Pennsylvania
2020-04-02,PR,316,1604,1920,72,Puerto Rico
2020-04-02,RI,730,4625,5355,44,Rhode Island
2020-04-02,SC,1554,5441,6995,45,South Carolina
2020-04-02,SD,165,4217,4382,46,South Dakota
2020-04-02,TN,2845,31766,34611,47,Tennessee
2020-04-02,TX,4669,46010,50679,48,Texas
2020-04-02,UT,1074,20155,21229,49,Utah
2020-04-02,VA,1706,15883,17589,51,Virginia
2020-04-02,VI,33,149,182,78,U.S. Virgin Islands
2020-04-02,VT,390,4384,4774,50,Vermont
2020-04-02,WA,9201,86091,95292,53,Washington
2020-04-02,WI,2040,20317,22357,55,Wisconsin
2020-04-02,WV,217,5276,5493,54,West Virginia
2020-04-02,WY,150,2439,2589,56,Wyoming
2020-04-01,AK,133,4470,4603,02,Alaska
2020-04-01,AL,1077,6697,7774,01,Alabama
2020-04-01,AR,584,7354,7938,05,Arkansas
2020-04-01,AS,0,3,3,60,American Samoa
2020-04-01,AZ,1413,19645,21058,04,Arizona
2020-04-01,CA,8155,21772,29927,06,California
2020-04-01,CO,2966,13883,16849,08,Colorado
2020-04-01,CT,3557,13043,16600,09,Connecticut
2020-04-01,DC,586,3262,3848,11,District of Columbia
2020-04-01,DE,368,4015,4383,10,Delaware
2020-04-01,FL,6955,59529,66484,12,Florida
2020-04-01,GA,4638,15688,20326,13,Georgia
2020-04-01,GU,77,406,483,66,Guam
2020-04-01,HI,208,8721,8929,15,Hawaii
2020-04-01,IA,549,7304,7853,19,Iowa
2020-04-01,ID,525,6076,6601,16,Idaho
2020-04-01,IL,6980,33404,40384,17,Illinois
2020-04-01,IN,2565,11810,14375,18,Indiana
2020-04-01,KS,482,5411,5893,20,Kansas
2020-04-01,KY,591,6965,7556,21,Kentucky
2020-04-01,LA,6424,39352,45776,22,Louisiana
2020-04-01,MA,7639,44125,51764,25,Massachusetts
2020-04-01,MD,1985,17233,19218,24,Maryland
2020-04-01,ME,344,6088,6432,23,Maine
2020-04-01,MI,20246,29951,50197,26,Michigan
2020-04-01,MN,973,21880,22853,27,Minnesota
2020-04-01,MO,1581,15846,17427,29,Missouri
2020-04-01,MP,6,NA,6,69,Northern Mariana Islands
2020-04-01,MS,1073,3712,4785,28,Mississippi
2020-04-01,MT,208,4710,4918,30,Montana
2020-04-01,NC,1584,24659,26243,37,North Carolina
2020-04-01,ND,142,4351,4493,38,North Dakota
2020-04-01,NE,210,3475,3685,31,Nebraska
2020-04-01,NH,415,5985,6400,33,New Hampshire
2020-04-01,NJ,22255,30387,52642,34,New Jersey
2020-04-01,NM,315,12925,13240,35,New Mexico
2020-04-01,NV,1279,11519,12798,32,Nevada
2020-04-01,NY,83712,137168,220880,36,New York
2020-04-01,OH,2547,26992,29539,39,Ohio
2020-04-01,OK,719,1248,1967,40,Oklahoma
2020-04-01,OR,736,13136,13872,41,Oregon
2020-04-01,PA,5805,42427,48232,42,Pennsylvania
2020-04-01,PR,286,1409,1695,72,Puerto Rico
2020-04-01,RI,668,4189,4857,44,Rhode Island
2020-04-01,SC,1293,5033,6326,45,South Carolina
2020-04-01,SD,129,3903,4032,46,South Dakota
2020-04-01,TN,2683,29769,32452,47,Tennessee
2020-04-01,TX,3997,43860,47857,48,Texas
2020-04-01,UT,1012,20155,21167,49,Utah
2020-04-01,VA,1484,13860,15344,51,Virginia
2020-04-01,VI,30,126,156,78,U.S. Virgin Islands
2020-04-01,VT,359,4162,4521,50,Vermont
2020-04-01,WA,8869,81516,90385,53,Washington
2020-04-01,WI,1821,18819,20640,55,Wisconsin
2020-04-01,WV,191,4384,4575,54,West Virginia
2020-04-01,WY,130,2218,2348,56,Wyoming
2020-03-31,AK,119,3594,3713,02,Alaska
2020-03-31,AL,981,6298,7279,01,Alabama
2020-03-31,AR,523,5959,6482,05,Arkansas
2020-03-31,AS,0,3,3,60,American Samoa
2020-03-31,AZ,1289,18082,19371,04,Arizona
2020-03-31,CA,7482,21772,29254,06,California
2020-03-31,CO,2627,12737,15364,08,Colorado
2020-03-31,CT,3128,13029,16157,09,Connecticut
2020-03-31,DC,495,3262,3757,11,District of Columbia
2020-03-31,DE,319,3696,4015,10,Delaware
2020-03-31,FL,6338,54285,60623,12,Florida
2020-03-31,GA,3929,12252,16181,13,Georgia
2020-03-31,GU,69,371,440,66,Guam
2020-03-31,HI,204,8471,8675,15,Hawaii
2020-03-31,IA,497,6888,7385,19,Iowa
2020-03-31,ID,415,5297,5712,16,Idaho
2020-03-31,IL,5994,29231,35225,17,Illinois
2020-03-31,IN,2159,11214,13373,18,Indiana
2020-03-31,KS,428,4996,5424,20,Kansas
2020-03-31,KY,480,6330,6810,21,Kentucky
2020-03-31,LA,5237,33730,38967,22,Louisiana
2020-03-31,MA,6521,40440,46961,25,Massachusetts
2020-03-31,MD,1660,14868,16528,24,Maryland
2020-03-31,ME,303,6088,6391,23,Maine
2020-03-31,MI,18654,26334,44988,26,Michigan
2020-03-31,MN,916,20935,21851,27,Minnesota
2020-03-31,MO,1327,14614,15941,29,Missouri
2020-03-31,MP,2,NA,2,69,Northern Mariana Islands
2020-03-31,MS,937,3537,4474,28,Mississippi
2020-03-31,MT,184,4234,4418,30,Montana
2020-03-31,NC,1498,21608,23106,37,North Carolina
2020-03-31,ND,126,4131,4257,38,North Dakota
2020-03-31,NE,172,2931,3103,31,Nebraska
2020-03-31,NH,314,5413,5727,33,New Hampshire
2020-03-31,NJ,18696,27077,45773,34,New Jersey
2020-03-31,NM,281,12246,12527,35,New Mexico
2020-03-31,NV,1113,10681,11794,32,Nevada
2020-03-31,NY,75795,129391,205186,36,New York
2020-03-31,OH,2199,26992,29191,39,Ohio
2020-03-31,OK,565,1229,1794,40,Oklahoma
2020-03-31,OR,690,13136,13826,41,Oregon
2020-03-31,PA,4843,37645,42488,42,Pennsylvania
2020-03-31,PR,239,1195,1434,72,Puerto Rico
2020-03-31,RI,568,3544,4112,44,Rhode Island
2020-03-31,SC,1083,4616,5699,45,South Carolina
2020-03-31,SD,108,3609,3717,46,South Dakota
2020-03-31,TN,2239,25121,27360,47,Tennessee
2020-03-31,TX,3266,39726,42992,48,Texas
2020-03-31,UT,887,17626,18513,49,Utah
2020-03-31,VA,1250,12151,13401,51,Virginia
2020-03-31,VI,30,126,156,78,U.S. Virgin Islands
2020-03-31,VT,320,3949,4269,50,Vermont
2020-03-31,WA,8431,77237,85668,53,Washington
2020-03-31,WI,1585,17375,18960,55,Wisconsin
2020-03-31,WV,162,3981,4143,54,West Virginia
2020-03-31,WY,109,1999,2108,56,Wyoming
2020-03-30,AK,114,3540,3654,02,Alaska
2020-03-30,AL,859,5694,6553,01,Alabama
2020-03-30,AR,473,5262,5735,05,Arkansas
2020-03-30,AS,NA,NA,0,60,American Samoa
2020-03-30,AZ,1157,15602,16759,04,Arizona
2020-03-30,CA,6447,20549,26996,06,California
2020-03-30,CO,2627,12737,15364,08,Colorado
2020-03-30,CT,2571,12029,14600,09,Connecticut
2020-03-30,DC,401,2682,3083,11,District of Columbia
2020-03-30,DE,264,2216,2480,10,Delaware
2020-03-30,FL,5473,48225,53698,12,Florida
2020-03-30,GA,2809,9915,12724,13,Georgia
2020-03-30,GU,58,352,410,66,Guam
2020-03-30,HI,175,7825,8000,15,Hawaii
2020-03-30,IA,424,6162,6586,19,Iowa
2020-03-30,ID,310,4396,4706,16,Idaho
2020-03-30,IL,5057,25389,30446,17,Illinois
2020-03-30,IN,1786,9872,11658,18,Indiana
2020-03-30,KS,368,4554,4922,20,Kansas
2020-03-30,KY,439,5579,6018,21,Kentucky
2020-03-30,LA,4025,30008,34033,22,Louisiana
2020-03-30,MA,5653,37166,42819,25,Massachusetts
2020-03-30,MD,1413,13316,14729,24,Maryland
2020-03-30,ME,275,3394,3669,23,Maine
2020-03-30,MI,17363,23263,40626,26,Michigan
2020-03-30,MN,823,19512,20335,27,Minnesota
2020-03-30,MO,1031,13204,14235,29,Missouri
2020-03-30,MP,2,NA,2,69,Northern Mariana Islands
2020-03-30,MS,847,2989,3836,28,Mississippi
2020-03-30,MT,171,4143,4314,30,Montana
2020-03-30,NC,1307,19557,20864,37,North Carolina
2020-03-30,ND,109,3728,3837,38,North Dakota
2020-03-30,NE,145,2584,2729,31,Nebraska
2020-03-30,NH,314,5386,5700,33,New Hampshire
2020-03-30,NJ,16636,25224,41860,34,New Jersey
2020-03-30,NM,237,10942,11179,35,New Mexico
2020-03-30,NV,1008,10207,11215,32,Nevada
2020-03-30,NY,66497,119971,186468,36,New York
2020-03-30,OH,1933,25342,27275,39,Ohio
2020-03-30,OK,481,1207,1688,40,Oklahoma
2020-03-30,OR,606,12277,12883,41,Oregon
2020-03-30,PA,4087,33777,37864,42,Pennsylvania
2020-03-30,PR,174,931,1105,72,Puerto Rico
2020-03-30,RI,495,3246,3741,44,Rhode Island
2020-03-30,SC,925,4160,5085,45,South Carolina
2020-03-30,SD,101,3478,3579,46,South Dakota
2020-03-30,TN,1834,21470,23304,47,Tennessee
2020-03-30,TX,2877,33003,35880,48,Texas
2020-03-30,UT,806,15197,16003,49,Utah
2020-03-30,VA,1020,11018,12038,51,Virginia
2020-03-30,VI,30,126,156,78,U.S. Virgin Islands
2020-03-30,VT,293,3718,4011,50,Vermont
2020-03-30,WA,8120,72842,80962,53,Washington
2020-03-30,WI,1422,15856,17278,55,Wisconsin
2020-03-30,WV,126,2984,3110,54,West Virginia
2020-03-30,WY,94,1840,1934,56,Wyoming
2020-03-29,AK,102,3232,3334,02,Alaska
2020-03-29,AL,806,4184,4990,01,Alabama
2020-03-29,AR,426,3027,3453,05,Arkansas
2020-03-29,AS,NA,NA,0,60,American Samoa
2020-03-29,AZ,919,12953,13872,04,Arizona
2020-03-29,CA,5708,20549,26257,06,California
2020-03-29,CO,2061,11215,13276,08,Colorado
2020-03-29,CT,1993,9907,11900,09,Connecticut
2020-03-29,DC,342,2469,2811,11,District of Columbia
2020-03-29,DE,232,36,268,10,Delaware
2020-03-29,FL,4246,39070,43316,12,Florida
2020-03-29,GA,2651,9913,12564,13,Georgia
2020-03-29,GU,56,334,390,66,Guam
2020-03-29,HI,151,6849,7000,15,Hawaii
2020-03-29,IA,336,5013,5349,19,Iowa
2020-03-29,ID,261,4021,4282,16,Idaho
2020-03-29,IL,4596,23166,27762,17,Illinois
2020-03-29,IN,1514,8316,9830,18,Indiana
2020-03-29,KS,319,4194,4513,20,Kansas
2020-03-29,KY,394,5147,5541,21,Kentucky
2020-03-29,LA,3540,24331,27871,22,Louisiana
2020-03-29,MA,4856,34234,39090,25,Massachusetts
2020-03-29,MD,1239,12354,13593,24,Maryland
2020-03-29,ME,253,3394,3647,23,Maine
2020-03-29,MI,15784,17417,33201,26,Michigan
2020-03-29,MN,725,18566,19291,27,Minnesota
2020-03-29,MO,838,11547,12385,29,Missouri
2020-03-29,MP,2,NA,2,69,Northern Mariana Islands
2020-03-29,MS,758,2560,3318,28,Mississippi
2020-03-29,MT,154,4143,4297,30,Montana
2020-03-29,NC,1040,17905,18945,37,North Carolina
2020-03-29,ND,98,3355,3453,38,North Dakota
2020-03-29,NE,108,1968,2076,31,Nebraska
2020-03-29,NH,214,4524,4738,33,New Hampshire
2020-03-29,NJ,13386,22216,35602,34,New Jersey
2020-03-29,NM,237,10769,11006,35,New Mexico
2020-03-29,NV,738,8412,9150,32,Nevada
2020-03-29,NY,59513,112847,172360,36,New York
2020-03-29,OH,1653,19012,20665,39,Ohio
2020-03-29,OK,429,1205,1634,40,Oklahoma
2020-03-29,OR,548,10878,11426,41,Oregon
2020-03-29,PA,3394,30061,33455,42,Pennsylvania
2020-03-29,PR,127,841,968,72,Puerto Rico
2020-03-29,RI,417,3056,3473,44,Rhode Island
2020-03-29,SC,774,3015,3789,45,South Carolina
2020-03-29,SD,90,3127,3217,46,South Dakota
2020-03-29,TN,1537,19037,20574,47,Tennessee
2020-03-29,TX,2552,23208,25760,48,Texas
2020-03-29,UT,719,13274,13993,49,Utah
2020-03-29,VA,890,9719,10609,51,Virginia
2020-03-29,VI,23,123,146,78,U.S. Virgin Islands
2020-03-29,VT,256,3483,3739,50,Vermont
2020-03-29,WA,7715,68097,75812,53,Washington
2020-03-29,WI,1276,16550,17826,55,Wisconsin
2020-03-29,WV,113,2705,2818,54,West Virginia
2020-03-29,WY,86,1554,1640,56,Wyoming
2020-03-28,AK,85,2836,2921,02,Alaska
2020-03-28,AL,696,4184,4880,01,Alabama
2020-03-28,AR,404,2938,3342,05,Arkansas
2020-03-28,AS,NA,NA,0,60,American Samoa
2020-03-28,AZ,873,7455,8328,04,Arizona
2020-03-28,CA,4643,20549,25192,06,California
2020-03-28,CO,1734,9942,11676,08,Colorado
2020-03-28,CT,1291,7109,8400,09,Connecticut
2020-03-28,DC,304,2211,2515,11,District of Columbia
2020-03-28,DE,214,36,250,10,Delaware
2020-03-28,FL,3763,35366,39129,12,Florida
2020-03-28,GA,2366,8685,11051,13,Georgia
2020-03-28,GU,55,299,354,66,Guam
2020-03-28,HI,120,4357,4477,15,Hawaii
2020-03-28,IA,298,4375,4673,19,Iowa
2020-03-28,ID,230,3342,3572,16,Idaho
2020-03-28,IL,3491,22000,25491,17,Illinois
2020-03-28,IN,1232,7175,8407,18,Indiana
2020-03-28,KS,261,3671,3932,20,Kansas
2020-03-28,KY,302,4821,5123,21,Kentucky
2020-03-28,LA,3315,21846,25161,22,Louisiana
2020-03-28,MA,4158,30915,35073,25,Massachusetts
2020-03-28,MD,992,11516,12508,24,Maryland
2020-03-28,ME,211,3394,3605,23,Maine
2020-03-28,MI,14865,15902,30767,26,Michigan
2020-03-28,MN,687,17395,18082,27,Minnesota
2020-03-28,MO,838,10082,10920,29,Missouri
2020-03-28,MP,2,NA,2,69,Northern Mariana Islands
2020-03-28,MS,663,2560,3223,28,Mississippi
2020-03-28,MT,129,3256,3385,30,Montana
2020-03-28,NC,935,16592,17527,37,North Carolina
2020-03-28,ND,83,2809,2892,38,North Dakota
2020-03-28,NE,96,1904,2000,31,Nebraska
2020-03-28,NH,187,3656,3843,33,New Hampshire
2020-03-28,NJ,11124,19386,30510,34,New Jersey
2020-03-28,NM,191,9196,9387,35,New Mexico
2020-03-28,NV,621,7901,8522,32,Nevada
2020-03-28,NY,52318,103616,155934,36,New York
2020-03-28,OH,1406,19012,20418,39,Ohio
2020-03-28,OK,377,1180,1557,40,Oklahoma
2020-03-28,OR,479,9693,10172,41,Oregon
2020-03-28,PA,2751,25254,28005,42,Pennsylvania
2020-03-28,PR,100,739,839,72,Puerto Rico
2020-03-28,RI,312,2742,3054,44,Rhode Island
2020-03-28,SC,539,2408,2947,45,South Carolina
2020-03-28,SD,68,2592,2660,46,South Dakota
2020-03-28,TN,1373,16965,18338,47,Tennessee
2020-03-28,TX,2052,23208,25260,48,Texas
2020-03-28,UT,602,10710,11312,49,Utah
2020-03-28,VA,739,8427,9166,51,Virginia
2020-03-28,VI,22,106,128,78,U.S. Virgin Islands
2020-03-28,VT,234,3192,3426,50,Vermont
2020-03-28,WA,7397,66582,73979,53,Washington
2020-03-28,WI,1134,15232,16366,55,Wisconsin
2020-03-28,WV,96,2331,2427,54,West Virginia
2020-03-28,WY,82,1475,1557,56,Wyoming
2020-03-27,AK,69,2319,2388,02,Alaska
2020-03-27,AL,587,4184,4771,01,Alabama
2020-03-27,AR,381,1545,1926,05,Arkansas
2020-03-27,AS,NA,NA,0,60,American Samoa
2020-03-27,AZ,736,7455,8191,04,Arizona
2020-03-27,CA,3879,17380,21259,06,California
2020-03-27,CO,1430,8692,10122,08,Colorado
2020-03-27,CT,1291,7109,8400,09,Connecticut
2020-03-27,DC,267,1897,2164,11,District of Columbia
2020-03-27,DE,163,36,199,10,Delaware
2020-03-27,FL,2765,28186,30951,12,Florida
2020-03-27,GA,2001,7864,9865,13,Georgia
2020-03-27,GU,51,299,350,66,Guam
2020-03-27,HI,106,4357,4463,15,Hawaii
2020-03-27,IA,235,3740,3975,19,Iowa
2020-03-27,ID,189,2668,2857,16,Idaho
2020-03-27,IL,3026,18516,21542,17,Illinois
2020-03-27,IN,981,5955,6936,18,Indiana
2020-03-27,KS,202,3229,3431,20,Kansas
2020-03-27,KY,248,3768,4016,21,Kentucky
2020-03-27,LA,2746,18613,21359,22,Louisiana
2020-03-27,MA,3151,26244,29395,25,Massachusetts
2020-03-27,MD,774,94,868,24,Maryland
2020-03-27,ME,168,3394,3562,23,Maine
2020-03-27,MI,13799,14140,27939,26,Michigan
2020-03-27,MN,640,13605,14245,27,Minnesota
2020-03-27,MO,669,369,1038,29,Missouri
2020-03-27,MP,0,NA,0,69,Northern Mariana Islands
2020-03-27,MS,579,2560,3139,28,Mississippi
2020-03-27,MT,108,2590,2698,30,Montana
2020-03-27,NC,763,14373,15136,37,North Carolina
2020-03-27,ND,65,2427,2492,38,North Dakota
2020-03-27,NE,85,1761,1846,31,Nebraska
2020-03-27,NH,158,3395,3553,33,New Hampshire
2020-03-27,NJ,8825,16547,25372,34,New Jersey
2020-03-27,NM,136,8377,8513,35,New Mexico
2020-03-27,NV,535,6161,6696,32,Nevada
2020-03-27,NY,44635,101118,145753,36,New York
2020-03-27,OH,1137,19012,20149,39,Ohio
2020-03-27,OK,322,1084,1406,40,Oklahoma
2020-03-27,OR,414,8510,8924,41,Oregon
2020-03-27,PA,2218,21016,23234,42,Pennsylvania
2020-03-27,PR,79,519,598,72,Puerto Rico
2020-03-27,RI,248,2502,2750,44,Rhode Island
2020-03-27,SC,456,2307,2763,45,South Carolina
2020-03-27,SD,58,2387,2445,46,South Dakota
2020-03-27,TN,1203,14888,16091,47,Tennessee
2020-03-27,TX,1731,21935,23666,48,Texas
2020-03-27,UT,480,8764,9244,49,Utah
2020-03-27,VA,604,6733,7337,51,Virginia
2020-03-27,VI,19,55,74,78,U.S. Virgin Islands
2020-03-27,VT,213,2868,3081,50,Vermont
2020-03-27,WA,7076,64302,71378,53,Washington
2020-03-27,WI,969,13140,14109,55,Wisconsin
2020-03-27,WV,76,1779,1855,54,West Virginia
2020-03-27,WY,70,1211,1281,56,Wyoming
2020-03-26,AK,59,1801,1860,02,Alaska
2020-03-26,AL,506,3593,4099,01,Alabama
2020-03-26,AR,335,1504,1839,05,Arkansas
2020-03-26,AS,NA,NA,0,60,American Samoa
2020-03-26,AZ,577,347,924,04,Arizona
2020-03-26,CA,3006,17380,20386,06,California
2020-03-26,CO,1086,6978,8064,08,Colorado
2020-03-26,CT,1012,5625,6637,09,Connecticut
2020-03-26,DC,231,1626,1857,11,District of Columbia
2020-03-26,DE,130,36,166,10,Delaware
2020-03-26,FL,2355,23741,26096,12,Florida
2020-03-26,GA,1525,7401,8926,13,Georgia
2020-03-26,GU,45,263,308,66,Guam
2020-03-26,HI,95,4357,4452,15,Hawaii
2020-03-26,IA,179,2578,2757,19,Iowa
2020-03-26,ID,123,2065,2188,16,Idaho
2020-03-26,IL,2538,14093,16631,17,Illinois
2020-03-26,IN,645,4006,4651,18,Indiana
2020-03-26,KS,168,2869,3037,20,Kansas
2020-03-26,KY,198,3102,3300,21,Kentucky
2020-03-26,LA,2305,15724,18029,22,Louisiana
2020-03-26,MA,2318,21327,23645,25,Massachusetts
2020-03-26,MD,580,94,674,24,Maryland
2020-03-26,ME,155,3394,3549,23,Maine
2020-03-26,MI,12475,11730,24205,26,Michigan
2020-03-26,MN,565,12604,13169,27,Minnesota
2020-03-26,MO,502,369,871,29,Missouri
2020-03-26,MP,0,NA,0,69,Northern Mariana Islands
2020-03-26,MS,485,2291,2776,28,Mississippi
2020-03-26,MT,71,2128,2199,30,Montana
2020-03-26,NC,636,12274,12910,37,North Carolina
2020-03-26,ND,52,2039,2091,38,North Dakota
2020-03-26,NE,73,1584,1657,31,Nebraska
2020-03-26,NH,137,3001,3138,33,New Hampshire
2020-03-26,NJ,6876,13661,20537,34,New Jersey
2020-03-26,NM,112,7681,7793,35,New Mexico
2020-03-26,NV,420,4697,5117,32,Nevada
2020-03-26,NY,37258,84846,122104,36,New York
2020-03-26,OH,867,16449,17316,39,Ohio
2020-03-26,OK,248,958,1206,40,Oklahoma
2020-03-26,OR,327,6953,7280,41,Oregon
2020-03-26,PA,1687,16441,18128,42,Pennsylvania
2020-03-26,PR,64,377,441,72,Puerto Rico
2020-03-26,RI,217,2300,2517,44,Rhode Island
2020-03-26,SC,456,2307,2763,45,South Carolina
2020-03-26,SD,46,1973,2019,46,South Dakota
2020-03-26,TN,957,13952,14909,47,Tennessee
2020-03-26,TX,1396,20028,21424,48,Texas
2020-03-26,UT,402,7308,7710,49,Utah
2020-03-26,VA,460,5729,6189,51,Virginia
2020-03-26,VI,17,55,72,78,U.S. Virgin Islands
2020-03-26,VT,185,2744,2929,50,Vermont
2020-03-26,WA,6700,60318,67018,53,Washington
2020-03-26,WI,806,11583,12389,55,Wisconsin
2020-03-26,WV,51,1031,1082,54,West Virginia
2020-03-26,WY,53,1052,1105,56,Wyoming
2020-03-25,AK,42,1649,1691,02,Alaska
2020-03-25,AL,283,2529,2812,01,Alabama
2020-03-25,AR,280,1437,1717,05,Arkansas
2020-03-25,AS,NA,NA,0,60,American Samoa
2020-03-25,AZ,450,323,773,04,Arizona
2020-03-25,CA,2355,15921,18276,06,California
2020-03-25,CO,912,6789,7701,08,Colorado
2020-03-25,CT,875,5023,5898,09,Connecticut
2020-03-25,DC,183,1423,1606,11,District of Columbia
2020-03-25,DE,115,36,151,10,Delaware
2020-03-25,FL,1682,15374,17056,12,Florida
2020-03-25,GA,1247,4932,6179,13,Georgia
2020-03-25,GU,37,233,270,66,Guam
2020-03-25,HI,90,4357,4447,15,Hawaii
2020-03-25,IA,145,2578,2723,19,Iowa
2020-03-25,ID,73,1887,1960,16,Idaho
2020-03-25,IL,1865,12344,14209,17,Illinois
2020-03-25,IN,477,2879,3356,18,Indiana
2020-03-25,KS,126,2360,2486,20,Kansas
2020-03-25,KY,157,2865,3022,21,Kentucky
2020-03-25,LA,1795,9656,11451,22,Louisiana
2020-03-25,MA,1739,18079,19818,25,Massachusetts
2020-03-25,MD,423,94,517,24,Maryland
2020-03-25,ME,149,3177,3326,23,Maine
2020-03-25,MI,11335,8842,20177,26,Michigan
2020-03-25,MN,502,11188,11690,27,Minnesota
2020-03-25,MO,356,369,725,29,Missouri
2020-03-25,MP,0,NA,0,69,Northern Mariana Islands
2020-03-25,MS,377,1566,1943,28,Mississippi
2020-03-25,MT,53,1948,2001,30,Montana
2020-03-25,NC,504,9985,10489,37,North Carolina
2020-03-25,ND,39,1734,1773,38,North Dakota
2020-03-25,NE,61,1304,1365,31,Nebraska
2020-03-25,NH,108,2356,2464,33,New Hampshire
2020-03-25,NJ,4402,10452,14854,34,New Jersey
2020-03-25,NM,100,6742,6842,35,New Mexico
2020-03-25,NV,321,4251,4572,32,Nevada
2020-03-25,NY,30811,72668,103479,36,New York
2020-03-25,OH,704,14060,14764,39,Ohio
2020-03-25,OK,164,805,969,40,Oklahoma
2020-03-25,OR,209,4350,4559,41,Oregon
2020-03-25,PA,1127,11193,12320,42,Pennsylvania
2020-03-25,PR,51,317,368,72,Puerto Rico
2020-03-25,RI,176,2124,2300,44,Rhode Island
2020-03-25,SC,424,2303,2727,45,South Carolina
2020-03-25,SD,41,819,860,46,South Dakota
2020-03-25,TN,784,11012,11796,47,Tennessee
2020-03-25,TX,974,12520,13494,48,Texas
2020-03-25,UT,346,6491,6837,49,Utah
2020-03-25,VA,391,4979,5370,51,Virginia
2020-03-25,VI,17,55,72,78,U.S. Virgin Islands
2020-03-25,VT,160,1810,1970,50,Vermont
2020-03-25,WA,6329,56218,62547,53,Washington
2020-03-25,WI,667,10089,10756,55,Wisconsin
2020-03-25,WV,39,759,798,54,West Virginia
2020-03-25,WY,44,954,998,56,Wyoming
2020-03-24,AK,36,986,1022,02,Alaska
2020-03-24,AL,215,2106,2321,01,Alabama
2020-03-24,AR,218,947,1165,05,Arkansas
2020-03-24,AS,NA,NA,0,60,American Samoa
2020-03-24,AZ,357,313,670,04,Arizona
2020-03-24,CA,2102,13452,15554,06,California
2020-03-24,CO,720,5504,6224,08,Colorado
2020-03-24,CT,618,4682,5300,09,Connecticut
2020-03-24,DC,137,1195,1332,11,District of Columbia
2020-03-24,DE,91,36,127,10,Delaware
2020-03-24,FL,1412,13127,14539,12,Florida
2020-03-24,GA,1026,4458,5484,13,Georgia
2020-03-24,GU,32,201,233,66,Guam
2020-03-24,HI,77,3589,3666,15,Hawaii
2020-03-24,IA,124,2315,2439,19,Iowa
2020-03-24,ID,50,1887,1937,16,Idaho
2020-03-24,IL,1535,9934,11469,17,Illinois
2020-03-24,IN,365,2566,2931,18,Indiana
2020-03-24,KS,98,2086,2184,20,Kansas
2020-03-24,KY,124,1762,1886,21,Kentucky
2020-03-24,LA,1388,7215,8603,22,Louisiana
2020-03-24,MA,1060,12714,13774,25,Massachusetts
2020-03-24,MD,349,94,443,24,Maryland
2020-03-24,ME,125,3014,3139,23,Maine
2020-03-24,MI,10155,6989,17144,26,Michigan
2020-03-24,MN,444,5550,5994,27,Minnesota
2020-03-24,MO,183,369,552,29,Missouri
2020-03-24,MP,0,NA,0,69,Northern Mariana Islands
2020-03-24,MS,320,1552,1872,28,Mississippi
2020-03-24,MT,46,1643,1689,30,Montana
2020-03-24,NC,398,8141,8539,37,North Carolina
2020-03-24,ND,34,1454,1488,38,North Dakota
2020-03-24,NE,52,975,1027,31,Nebraska
2020-03-24,NH,101,1447,1548,33,New Hampshire
2020-03-24,NJ,3675,8325,12000,34,New Jersey
2020-03-24,NM,83,5890,5973,35,New Mexico
2020-03-24,NV,278,3954,4232,32,Nevada
2020-03-24,NY,25665,65605,91270,36,New York
2020-03-24,OH,564,140,704,39,Ohio
2020-03-24,OK,106,735,841,40,Oklahoma
2020-03-24,OR,209,4350,4559,41,Oregon
2020-03-24,PA,851,8643,9494,42,Pennsylvania
2020-03-24,PR,39,268,307,72,Puerto Rico
2020-03-24,RI,148,1951,2099,44,Rhode Island
2020-03-24,SC,298,2012,2310,45,South Carolina
2020-03-24,SD,30,790,820,46,South Dakota
2020-03-24,TN,667,10517,11184,47,Tennessee
2020-03-24,TX,410,10757,11167,48,Texas
2020-03-24,UT,299,5524,5823,49,Utah
2020-03-24,VA,290,4180,4470,51,Virginia
2020-03-24,VI,17,NA,17,78,U.S. Virgin Islands
2020-03-24,VT,125,1569,1694,50,Vermont
2020-03-24,WA,5923,51617,57540,53,Washington
2020-03-24,WI,525,8237,8762,55,Wisconsin
2020-03-24,WV,20,610,630,54,West Virginia
2020-03-24,WY,29,710,739,56,Wyoming
2020-03-23,AK,22,946,968,02,Alaska
2020-03-23,AL,167,1665,1832,01,Alabama
2020-03-23,AR,174,906,1080,05,Arkansas
2020-03-23,AS,NA,NA,0,60,American Samoa
2020-03-23,AZ,265,309,574,04,Arizona
2020-03-23,CA,1733,12567,14300,06,California
2020-03-23,CO,591,4845,5436,08,Colorado
2020-03-23,CT,415,4085,4500,09,Connecticut
2020-03-23,DC,116,1113,1229,11,District of Columbia
2020-03-23,DE,68,36,104,10,Delaware
2020-03-23,FL,1171,11063,12234,12,Florida
2020-03-23,GA,772,4297,5069,13,Georgia
2020-03-23,GU,29,161,190,66,Guam
2020-03-23,HI,56,2955,3011,15,Hawaii
2020-03-23,IA,105,2043,2148,19,Iowa
2020-03-23,ID,47,1309,1356,16,Idaho
2020-03-23,IL,1273,8583,9856,17,Illinois
2020-03-23,IN,259,1701,1960,18,Indiana
2020-03-23,KS,82,417,499,20,Kansas
2020-03-23,KY,104,1762,1866,21,Kentucky
2020-03-23,LA,1172,4776,5948,22,Louisiana
2020-03-23,MA,678,8263,8941,25,Massachusetts
2020-03-23,MD,288,94,382,24,Maryland
2020-03-23,ME,107,2791,2898,23,Maine
2020-03-23,MI,9062,5847,14909,26,Michigan
2020-03-23,MN,393,4511,4904,27,Minnesota
2020-03-23,MO,183,369,552,29,Missouri
2020-03-23,MP,0,NA,0,69,Northern Mariana Islands
2020-03-23,MS,249,1143,1392,28,Mississippi
2020-03-23,MT,34,1146,1180,30,Montana
2020-03-23,NC,297,8141,8438,37,North Carolina
2020-03-23,ND,30,1353,1383,38,North Dakota
2020-03-23,NE,50,356,406,31,Nebraska
2020-03-23,NH,78,1374,1452,33,New Hampshire
2020-03-23,NJ,2844,359,3203,34,New Jersey
2020-03-23,NM,65,5321,5386,35,New Mexico
2020-03-23,NV,245,3490,3735,32,Nevada
2020-03-23,NY,20875,57414,78289,36,New York
2020-03-23,OH,442,140,582,39,Ohio
2020-03-23,OK,81,694,775,40,Oklahoma
2020-03-23,OR,191,3649,3840,41,Oregon
2020-03-23,PA,644,6595,7239,42,Pennsylvania
2020-03-23,PR,31,189,220,72,Puerto Rico
2020-03-23,RI,129,1713,1842,44,Rhode Island
2020-03-23,SC,298,1466,1764,45,South Carolina
2020-03-23,SD,28,762,790,46,South Dakota
2020-03-23,TN,615,3272,3887,47,Tennessee
2020-03-23,TX,352,9703,10055,48,Texas
2020-03-23,UT,257,4790,5047,49,Utah
2020-03-23,VA,254,3443,3697,51,Virginia
2020-03-23,VI,17,NA,17,78,U.S. Virgin Islands
2020-03-23,VT,97,1424,1521,50,Vermont
2020-03-23,WA,5568,46745,52313,53,Washington
2020-03-23,WI,466,7050,7516,55,Wisconsin
2020-03-23,WV,16,444,460,54,West Virginia
2020-03-23,WY,26,592,618,56,Wyoming
2020-03-22,AK,22,946,968,02,Alaska
2020-03-22,AL,138,1464,1602,01,Alabama
2020-03-22,AR,165,711,876,05,Arkansas
2020-03-22,AS,NA,NA,0,60,American Samoa
2020-03-22,AZ,152,282,434,04,Arizona
2020-03-22,CA,1536,11304,12840,06,California
2020-03-22,CO,475,4075,4550,08,Colorado
2020-03-22,CT,223,2877,3100,09,Connecticut
2020-03-22,DC,98,957,1055,11,District of Columbia
2020-03-22,DE,56,36,92,10,Delaware
2020-03-22,FL,830,7990,8820,12,Florida
2020-03-22,GA,600,3420,4020,13,Georgia
2020-03-22,GU,27,126,153,66,Guam
2020-03-22,HI,48,263,311,15,Hawaii
2020-03-22,IA,90,1215,1305,19,Iowa
2020-03-22,ID,42,1175,1217,16,Idaho
2020-03-22,IL,1049,7271,8320,17,Illinois
2020-03-22,IN,201,1293,1494,18,Indiana
2020-03-22,KS,64,417,481,20,Kansas
2020-03-22,KY,99,1472,1571,21,Kentucky
2020-03-22,LA,837,2661,3498,22,Louisiana
2020-03-22,MA,547,5476,6023,25,Massachusetts
2020-03-22,MD,244,94,338,24,Maryland
2020-03-22,ME,89,2264,2353,23,Maine
2020-03-22,MI,7822,4791,12613,26,Michigan
2020-03-22,MN,349,4511,4860,27,Minnesota
2020-03-22,MO,90,369,459,29,Missouri
2020-03-22,MP,0,NA,0,69,Northern Mariana Islands
2020-03-22,MS,207,1114,1321,28,Mississippi
2020-03-22,MT,31,1146,1177,30,Montana
2020-03-22,NC,255,6183,6438,37,North Carolina
2020-03-22,ND,28,1260,1288,38,North Dakota
2020-03-22,NE,48,356,404,31,Nebraska
2020-03-22,NH,65,1188,1253,33,New Hampshire
2020-03-22,NJ,1914,327,2241,34,New Jersey
2020-03-22,NM,57,4722,4779,35,New Mexico
2020-03-22,NV,190,2448,2638,32,Nevada
2020-03-22,NY,15168,46233,61401,36,New York
2020-03-22,OH,351,140,491,39,Ohio
2020-03-22,OK,67,669,736,40,Oklahoma
2020-03-22,OR,161,2864,3025,41,Oregon
2020-03-22,PA,479,4964,5443,42,Pennsylvania
2020-03-22,PR,23,183,206,72,Puerto Rico
2020-03-22,RI,113,1547,1660,44,Rhode Island
2020-03-22,SC,195,1466,1661,45,South Carolina
2020-03-22,SD,21,740,761,46,South Dakota
2020-03-22,TN,505,3272,3777,47,Tennessee
2020-03-22,TX,334,8422,8756,48,Texas
2020-03-22,UT,181,3508,3689,49,Utah
2020-03-22,VA,219,3118,3337,51,Virginia
2020-03-22,VI,6,NA,6,78,U.S. Virgin Islands
2020-03-22,VT,76,1204,1280,50,Vermont
2020-03-22,WA,5121,41889,47010,53,Washington
2020-03-22,WI,425,6230,6655,55,Wisconsin
2020-03-22,WV,12,385,397,54,West Virginia
2020-03-22,WY,24,438,462,56,Wyoming
2020-03-21,AK,14,758,772,02,Alaska
2020-03-21,AL,124,28,152,01,Alabama
2020-03-21,AR,118,567,685,05,Arkansas
2020-03-21,AS,NA,NA,0,60,American Samoa
2020-03-21,AZ,104,240,344,04,Arizona
2020-03-21,CA,1279,11249,12528,06,California
2020-03-21,CO,363,3317,3680,08,Colorado
2020-03-21,CT,194,2106,2300,09,Connecticut
2020-03-21,DC,77,506,583,11,District of Columbia
2020-03-21,DE,45,36,81,10,Delaware
2020-03-21,FL,658,6579,7237,12,Florida
2020-03-21,GA,507,2557,3064,13,Georgia
2020-03-21,GU,15,108,123,66,Guam
2020-03-21,HI,37,124,161,15,Hawaii
2020-03-21,IA,68,1049,1117,19,Iowa
2020-03-21,ID,31,880,911,16,Idaho
2020-03-21,IL,753,5488,6241,17,Illinois
2020-03-21,IN,126,707,833,18,Indiana
2020-03-21,KS,55,417,472,20,Kansas
2020-03-21,KY,54,714,768,21,Kentucky
2020-03-21,LA,580,2180,2760,22,Louisiana
2020-03-21,MA,426,4799,5225,25,Massachusetts
2020-03-21,MD,190,94,284,24,Maryland
2020-03-21,ME,73,2264,2337,23,Maine
2020-03-21,MI,7023,4086,11109,26,Michigan
2020-03-21,MN,327,3952,4279,27,Minnesota
2020-03-21,MO,73,369,442,29,Missouri
2020-03-21,MP,0,NA,0,69,Northern Mariana Islands
2020-03-21,MS,140,695,835,28,Mississippi
2020-03-21,MT,20,1146,1166,30,Montana
2020-03-21,NC,184,5092,5276,37,North Carolina
2020-03-21,ND,28,1141,1169,38,North Dakota
2020-03-21,NE,38,356,394,31,Nebraska
2020-03-21,NH,55,973,1028,33,New Hampshire
2020-03-21,NJ,1327,294,1621,34,New Jersey
2020-03-21,NM,57,3771,3828,35,New Mexico
2020-03-21,NV,124,2384,2508,32,Nevada
2020-03-21,NY,10356,35081,45437,36,New York
2020-03-21,OH,247,140,387,39,Ohio
2020-03-21,OK,53,560,613,40,Oklahoma
2020-03-21,OR,114,2003,2117,41,Oregon
2020-03-21,PA,371,3766,4137,42,Pennsylvania
2020-03-21,PR,21,143,164,72,Puerto Rico
2020-03-21,RI,88,1284,1372,44,Rhode Island
2020-03-21,SC,152,1255,1407,45,South Carolina
2020-03-21,SD,14,691,705,46,South Dakota
2020-03-21,TN,371,3272,3643,47,Tennessee
2020-03-21,TX,304,6218,6522,48,Texas
2020-03-21,UT,136,2424,2560,49,Utah
2020-03-21,VA,152,2638,2790,51,Virginia
2020-03-21,VI,6,NA,6,78,U.S. Virgin Islands
2020-03-21,VT,52,1080,1132,50,Vermont
2020-03-21,WA,4837,40285,45122,53,Washington
2020-03-21,WI,315,4628,4943,55,Wisconsin
2020-03-21,WV,11,330,341,54,West Virginia
2020-03-21,WY,23,438,461,56,Wyoming
2020-03-20,AK,12,686,698,02,Alaska
2020-03-20,AL,81,28,109,01,Alabama
2020-03-20,AR,96,351,447,05,Arkansas
2020-03-20,AS,NA,NA,0,60,American Samoa
2020-03-20,AZ,65,211,276,04,Arizona
2020-03-20,CA,1063,10424,11487,06,California
2020-03-20,CO,277,2675,2952,08,Colorado
2020-03-20,CT,194,604,798,09,Connecticut
2020-03-20,DC,71,501,572,11,District of Columbia
2020-03-20,DE,38,36,74,10,Delaware
2020-03-20,FL,520,1870,2390,12,Florida
2020-03-20,GA,420,1966,2386,13,Georgia
2020-03-20,GU,14,86,100,66,Guam
2020-03-20,HI,26,124,150,15,Hawaii
2020-03-20,IA,45,642,687,19,Iowa
2020-03-20,ID,23,590,613,16,Idaho
2020-03-20,IL,585,3696,4281,17,Illinois
2020-03-20,IN,79,475,554,18,Indiana
2020-03-20,KS,44,417,461,20,Kansas
2020-03-20,KY,47,592,639,21,Kentucky
2020-03-20,LA,473,568,1041,22,Louisiana
2020-03-20,MA,314,3795,4109,25,Massachusetts
2020-03-20,MD,149,94,243,24,Maryland
2020-03-20,ME,57,2264,2321,23,Maine
2020-03-20,MI,6219,3041,9260,26,Michigan
2020-03-20,MN,303,3741,4044,27,Minnesota
2020-03-20,MO,47,369,416,29,Missouri
2020-03-20,MP,0,NA,0,69,Northern Mariana Islands
2020-03-20,MS,80,695,775,28,Mississippi
2020-03-20,MT,16,931,947,30,Montana
2020-03-20,NC,137,3096,3233,37,North Carolina
2020-03-20,ND,20,800,820,38,North Dakota
2020-03-20,NE,32,240,272,31,Nebraska
2020-03-20,NH,44,745,789,33,New Hampshire
2020-03-20,NJ,890,264,1154,34,New Jersey
2020-03-20,NM,43,3771,3814,35,New Mexico
2020-03-20,NV,109,1992,2101,32,Nevada
2020-03-20,NY,7102,25325,32427,36,New York
2020-03-20,OH,169,140,309,39,Ohio
2020-03-20,OK,49,538,587,40,Oklahoma
2020-03-20,OR,114,2003,2117,41,Oregon
2020-03-20,PA,268,2574,2842,42,Pennsylvania
2020-03-20,PR,14,114,128,72,Puerto Rico
2020-03-20,RI,74,1161,1235,44,Rhode Island
2020-03-20,SC,81,833,914,45,South Carolina
2020-03-20,SD,14,663,677,46,South Dakota
2020-03-20,TN,228,563,791,47,Tennessee
2020-03-20,TX,194,5083,5277,48,Texas
2020-03-20,UT,112,2035,2147,49,Utah
2020-03-20,VA,114,2211,2325,51,Virginia
2020-03-20,VI,3,NA,3,78,U.S. Virgin Islands
2020-03-20,VT,44,957,1001,50,Vermont
2020-03-20,WA,4551,38229,42780,53,Washington
2020-03-20,WI,235,3455,3690,55,Wisconsin
2020-03-20,WV,7,219,226,54,West Virginia
2020-03-20,WY,19,331,350,56,Wyoming
2020-03-19,AK,6,432,438,02,Alaska
2020-03-19,AL,68,28,96,01,Alabama
2020-03-19,AR,46,310,356,05,Arkansas
2020-03-19,AS,NA,NA,0,60,American Samoa
2020-03-19,AZ,44,175,219,04,Arizona
2020-03-19,CA,924,8787,9711,06,California
2020-03-19,CO,216,2112,2328,08,Colorado
2020-03-19,CT,96,604,700,09,Connecticut
2020-03-19,DC,39,153,192,11,District of Columbia
2020-03-19,DE,30,36,66,10,Delaware
2020-03-19,FL,390,1533,1923,12,Florida
2020-03-19,GA,287,1544,1831,13,Georgia
2020-03-19,GU,12,69,81,66,Guam
2020-03-19,HI,16,93,109,15,Hawaii
2020-03-19,IA,38,83,121,19,Iowa
2020-03-19,ID,11,459,470,16,Idaho
2020-03-19,IL,422,2725,3147,17,Illinois
2020-03-19,IN,56,324,380,18,Indiana
2020-03-19,KS,34,417,451,20,Kansas
2020-03-19,KY,35,454,489,21,Kentucky
2020-03-19,LA,347,458,805,22,Louisiana
2020-03-19,MA,229,2918,3147,25,Massachusetts
2020-03-19,MD,107,94,201,24,Maryland
2020-03-19,ME,53,2004,2057,23,Maine
2020-03-19,MI,5276,2051,7327,26,Michigan
2020-03-19,MN,287,2949,3236,27,Minnesota
2020-03-19,MO,24,308,332,29,Missouri
2020-03-19,MP,0,NA,0,69,Northern Mariana Islands
2020-03-19,MS,50,552,602,28,Mississippi
2020-03-19,MT,12,761,773,30,Montana
2020-03-19,NC,97,2408,2505,37,North Carolina
2020-03-19,ND,15,493,508,38,North Dakota
2020-03-19,NE,27,240,267,31,Nebraska
2020-03-19,NH,39,621,660,33,New Hampshire
2020-03-19,NJ,742,210,952,34,New Jersey
2020-03-19,NM,35,2762,2797,35,New Mexico
2020-03-19,NV,95,1626,1721,32,Nevada
2020-03-19,NY,4152,18132,22284,36,New York
2020-03-19,OH,119,140,259,39,Ohio
2020-03-19,OK,44,466,510,40,Oklahoma
2020-03-19,OR,88,1329,1417,41,Oregon
2020-03-19,PA,185,1608,1793,42,Pennsylvania
2020-03-19,PR,5,56,61,72,Puerto Rico
2020-03-19,RI,61,968,1029,44,Rhode Island
2020-03-19,SC,60,583,643,45,South Carolina
2020-03-19,SD,11,551,562,46,South Dakota
2020-03-19,TN,154,349,503,47,Tennessee
2020-03-19,TX,143,2212,2355,48,Texas
2020-03-19,UT,78,1448,1526,49,Utah
2020-03-19,VA,94,1829,1923,51,Virginia
2020-03-19,VI,3,NA,3,78,U.S. Virgin Islands
2020-03-19,VT,28,764,792,50,Vermont
2020-03-19,WA,4146,34573,38719,53,Washington
2020-03-19,WI,174,2192,2366,55,Wisconsin
2020-03-19,WV,2,143,145,54,West Virginia
2020-03-19,WY,18,271,289,56,Wyoming
2020-03-18,AK,6,406,412,02,Alaska
2020-03-18,AL,46,28,74,01,Alabama
2020-03-18,AR,33,236,269,05,Arkansas
2020-03-18,AS,NA,NA,0,60,American Samoa
2020-03-18,AZ,28,148,176,04,Arizona
2020-03-18,CA,611,7981,8592,06,California
2020-03-18,CO,183,1617,1800,08,Colorado
2020-03-18,CT,68,125,193,09,Connecticut
2020-03-18,DC,31,138,169,11,District of Columbia
2020-03-18,DE,25,36,61,10,Delaware
2020-03-18,FL,314,1225,1539,12,Florida
2020-03-18,GA,197,1311,1508,13,Georgia
2020-03-18,GU,8,57,65,66,Guam
2020-03-18,HI,14,93,107,15,Hawaii
2020-03-18,IA,29,83,112,19,Iowa
2020-03-18,ID,9,459,468,16,Idaho
2020-03-18,IL,288,1763,2051,17,Illinois
2020-03-18,IN,39,154,193,18,Indiana
2020-03-18,KS,16,417,433,20,Kansas
2020-03-18,KY,26,354,380,21,Kentucky
2020-03-18,LA,240,335,575,22,Louisiana
2020-03-18,MA,156,2115,2271,25,Massachusetts
2020-03-18,MD,85,94,179,24,Maryland
2020-03-18,ME,43,1670,1713,23,Maine
2020-03-18,MI,4531,1478,6009,26,Michigan
2020-03-18,MN,269,2685,2954,27,Minnesota
2020-03-18,MO,13,253,266,29,Missouri
2020-03-18,MP,0,NA,0,69,Northern Mariana Islands
2020-03-18,MS,34,479,513,28,Mississippi
2020-03-18,MT,10,499,509,30,Montana
2020-03-18,NC,63,1787,1850,37,North Carolina
2020-03-18,ND,6,268,274,38,North Dakota
2020-03-18,NE,24,206,230,31,Nebraska
2020-03-18,NH,26,513,539,33,New Hampshire
2020-03-18,NJ,427,190,617,34,New Jersey
2020-03-18,NM,28,2326,2354,35,New Mexico
2020-03-18,NV,55,168,223,32,Nevada
2020-03-18,NY,2382,12215,14597,36,New York
2020-03-18,OH,88,140,228,39,Ohio
2020-03-18,OK,29,378,407,40,Oklahoma
2020-03-18,OR,75,1118,1193,41,Oregon
2020-03-18,PA,133,1187,1320,42,Pennsylvania
2020-03-18,PR,5,31,36,72,Puerto Rico
2020-03-18,RI,44,719,763,44,Rhode Island
2020-03-18,SC,60,583,643,45,South Carolina
2020-03-18,SD,11,551,562,46,South Dakota
2020-03-18,TN,98,349,447,47,Tennessee
2020-03-18,TX,83,1824,1907,48,Texas
2020-03-18,UT,63,131,194,49,Utah
2020-03-18,VA,77,1201,1278,51,Virginia
2020-03-18,VI,2,NA,2,78,U.S. Virgin Islands
2020-03-18,VT,21,637,658,50,Vermont
2020-03-18,WA,3810,30359,34169,53,Washington
2020-03-18,WI,121,1577,1698,55,Wisconsin
2020-03-18,WV,1,122,123,54,West Virginia
2020-03-18,WY,15,178,193,56,Wyoming
2020-03-17,AK,3,334,337,02,Alaska
2020-03-17,AL,36,28,64,01,Alabama
2020-03-17,AR,22,197,219,05,Arkansas
2020-03-17,AS,NA,NA,0,60,American Samoa
2020-03-17,AZ,20,142,162,04,Arizona
2020-03-17,CA,483,7981,8464,06,California
2020-03-17,CO,160,1056,1216,08,Colorado
2020-03-17,CT,41,125,166,09,Connecticut
2020-03-17,DC,22,104,126,11,District of Columbia
2020-03-17,DE,16,36,52,10,Delaware
2020-03-17,FL,186,940,1126,12,Florida
2020-03-17,GA,146,NA,146,13,Georgia
2020-03-17,GU,5,41,46,66,Guam
2020-03-17,HI,10,NA,10,15,Hawaii
2020-03-17,IA,23,83,106,19,Iowa
2020-03-17,ID,7,346,353,16,Idaho
2020-03-17,IL,159,1340,1499,17,Illinois
2020-03-17,IN,30,129,159,18,Indiana
2020-03-17,KS,15,382,397,20,Kansas
2020-03-17,KY,22,295,317,21,Kentucky
2020-03-17,LA,137,286,423,22,Louisiana
2020-03-17,MA,118,1633,1751,25,Massachusetts
2020-03-17,MD,57,94,151,24,Maryland
2020-03-17,ME,32,1303,1335,23,Maine
2020-03-17,MI,3659,879,4538,26,Michigan
2020-03-17,MN,246,2276,2522,27,Minnesota
2020-03-17,MO,8,207,215,29,Missouri
2020-03-17,MP,0,NA,0,69,Northern Mariana Islands
2020-03-17,MS,21,368,389,28,Mississippi
2020-03-17,MT,8,303,311,30,Montana
2020-03-17,NC,40,474,514,37,North Carolina
2020-03-17,ND,3,220,223,38,North Dakota
2020-03-17,NE,21,206,227,31,Nebraska
2020-03-17,NH,17,355,372,33,New Hampshire
2020-03-17,NJ,267,163,430,34,New Jersey
2020-03-17,NM,23,1249,1272,35,New Mexico
2020-03-17,NV,55,168,223,32,Nevada
2020-03-17,NY,1700,5506,7206,36,New York
2020-03-17,OH,67,140,207,39,Ohio
2020-03-17,OK,17,247,264,40,Oklahoma
2020-03-17,OR,47,689,736,41,Oregon
2020-03-17,PA,96,879,975,42,Pennsylvania
2020-03-17,PR,5,13,18,72,Puerto Rico
2020-03-17,RI,33,608,641,44,Rhode Island
2020-03-17,SC,33,311,344,45,South Carolina
2020-03-17,SD,11,551,562,46,South Dakota
2020-03-17,TN,73,330,403,47,Tennessee
2020-03-17,TX,64,1204,1268,48,Texas
2020-03-17,UT,51,131,182,49,Utah
2020-03-17,VA,67,961,1028,51,Virginia
2020-03-17,VI,2,NA,2,78,U.S. Virgin Islands
2020-03-17,VT,19,581,600,50,Vermont
2020-03-17,WA,3432,25997,29429,53,Washington
2020-03-17,WI,83,1038,1121,55,Wisconsin
2020-03-17,WV,0,80,80,54,West Virginia
2020-03-17,WY,10,95,105,56,Wyoming
2020-03-16,AK,1,143,144,02,Alaska
2020-03-16,AL,28,28,56,01,Alabama
2020-03-16,AR,22,132,154,05,Arkansas
2020-03-16,AS,NA,NA,0,60,American Samoa
2020-03-16,AZ,18,125,143,04,Arizona
2020-03-16,CA,335,7981,8316,06,California
2020-03-16,CO,131,627,758,08,Colorado
2020-03-16,CT,26,125,151,09,Connecticut
2020-03-16,DC,17,96,113,11,District of Columbia
2020-03-16,DE,8,36,44,10,Delaware
2020-03-16,FL,141,684,825,12,Florida
2020-03-16,GA,121,NA,121,13,Georgia
2020-03-16,GU,3,23,26,66,Guam
2020-03-16,HI,7,NA,7,15,Hawaii
2020-03-16,IA,22,83,105,19,Iowa
2020-03-16,ID,5,265,270,16,Idaho
2020-03-16,IL,93,932,1025,17,Illinois
2020-03-16,IN,24,115,139,18,Indiana
2020-03-16,KS,11,166,177,20,Kansas
2020-03-16,KY,21,234,255,21,Kentucky
2020-03-16,LA,115,188,303,22,Louisiana
2020-03-16,MA,97,1199,1296,25,Massachusetts
2020-03-16,MD,37,94,131,24,Maryland
2020-03-16,ME,17,764,781,23,Maine
2020-03-16,MI,1933,272,2205,26,Michigan
2020-03-16,MN,179,1839,2018,27,Minnesota
2020-03-16,MO,6,164,170,29,Missouri
2020-03-16,MP,0,NA,0,69,Northern Mariana Islands
2020-03-16,MS,12,277,289,28,Mississippi
2020-03-16,MT,7,198,205,30,Montana
2020-03-16,NC,33,296,329,37,North Carolina
2020-03-16,ND,1,123,124,38,North Dakota
2020-03-16,NE,18,170,188,31,Nebraska
2020-03-16,NH,13,271,284,33,New Hampshire
2020-03-16,NJ,178,120,298,34,New Jersey
2020-03-16,NM,17,566,583,35,New Mexico
2020-03-16,NV,45,168,213,32,Nevada
2020-03-16,NY,950,4543,5493,36,New York
2020-03-16,OH,50,140,190,39,Ohio
2020-03-16,OK,10,174,184,40,Oklahoma
2020-03-16,OR,39,579,618,41,Oregon
2020-03-16,PA,76,670,746,42,Pennsylvania
2020-03-16,PR,5,9,14,72,Puerto Rico
2020-03-16,RI,22,455,477,44,Rhode Island
2020-03-16,SC,28,235,263,45,South Carolina
2020-03-16,SD,10,494,504,46,South Dakota
2020-03-16,TN,52,270,322,47,Tennessee
2020-03-16,TX,57,NA,57,48,Texas
2020-03-16,UT,39,131,170,49,Utah
2020-03-16,VA,51,438,489,51,Virginia
2020-03-16,VI,1,NA,1,78,U.S. Virgin Islands
2020-03-16,VT,17,487,504,50,Vermont
2020-03-16,WA,3107,21684,24791,53,Washington
2020-03-16,WI,56,504,560,55,Wisconsin
2020-03-16,WV,0,80,80,54,West Virginia
2020-03-16,WY,3,NA,3,56,Wyoming
2020-03-15,AK,1,143,144,02,Alaska
2020-03-15,AL,12,28,40,01,Alabama
2020-03-15,AR,16,103,119,05,Arkansas
2020-03-15,AZ,12,121,133,04,Arizona
2020-03-15,CA,293,916,1209,06,California
2020-03-15,CO,131,627,758,08,Colorado
2020-03-15,CT,20,125,145,09,Connecticut
2020-03-15,DC,16,79,95,11,District of Columbia
2020-03-15,DE,6,36,42,10,Delaware
2020-03-15,FL,116,678,794,12,Florida
2020-03-15,GA,99,NA,99,13,Georgia
2020-03-15,HI,2,NA,2,15,Hawaii
2020-03-15,IA,18,83,101,19,Iowa
2020-03-15,ID,5,174,179,16,Idaho
2020-03-15,IL,64,449,513,17,Illinois
2020-03-15,IN,19,102,121,18,Indiana
2020-03-15,KS,8,135,143,20,Kansas
2020-03-15,KY,16,139,155,21,Kentucky
2020-03-15,LA,90,156,246,22,Louisiana
2020-03-15,MA,64,584,648,25,Massachusetts
2020-03-15,MD,31,94,125,24,Maryland
2020-03-15,ME,3,91,94,23,Maine
2020-03-15,MI,1480,205,1685,26,Michigan
2020-03-15,MN,128,1387,1515,27,Minnesota
2020-03-15,MO,5,122,127,29,Missouri
2020-03-15,MS,10,84,94,28,Mississippi
2020-03-15,MT,7,103,110,30,Montana
2020-03-15,NC,32,227,259,37,North Carolina
2020-03-15,ND,1,95,96,38,North Dakota
2020-03-15,NE,17,80,97,31,Nebraska
2020-03-15,NH,13,271,284,33,New Hampshire
2020-03-15,NJ,98,120,218,34,New Jersey
2020-03-15,NM,13,482,495,35,New Mexico
2020-03-15,NV,21,168,189,32,Nevada
2020-03-15,NY,729,4543,5272,36,New York
2020-03-15,OH,36,139,175,39,Ohio
2020-03-15,OK,9,118,127,40,Oklahoma
2020-03-15,OR,36,420,456,41,Oregon
2020-03-15,PA,63,205,268,42,Pennsylvania
2020-03-15,RI,20,364,384,44,Rhode Island
2020-03-15,SC,19,154,173,45,South Carolina
2020-03-15,SD,9,327,336,46,South Dakota
2020-03-15,TN,39,157,196,47,Tennessee
2020-03-15,TX,56,NA,56,48,Texas
2020-03-15,UT,28,131,159,49,Utah
2020-03-15,VA,45,363,408,51,Virginia
2020-03-15,VT,12,405,417,50,Vermont
2020-03-15,WA,2738,17158,19896,53,Washington
2020-03-15,WI,37,313,350,55,Wisconsin
2020-03-15,WV,0,38,38,54,West Virginia
2020-03-15,WY,3,NA,3,56,Wyoming
2020-03-14,AK,1,143,144,02,Alaska
2020-03-14,AL,6,22,28,01,Alabama
2020-03-14,AR,12,65,77,05,Arkansas
2020-03-14,AZ,12,121,133,04,Arizona
2020-03-14,CA,252,916,1168,06,California
2020-03-14,CO,101,610,711,08,Colorado
2020-03-14,CT,11,125,136,09,Connecticut
2020-03-14,DC,10,49,59,11,District of Columbia
2020-03-14,DE,6,36,42,10,Delaware
2020-03-14,FL,77,478,555,12,Florida
2020-03-14,GA,66,NA,66,13,Georgia
2020-03-14,HI,2,NA,2,15,Hawaii
2020-03-14,IA,17,83,100,19,Iowa
2020-03-14,ID,2,174,176,16,Idaho
2020-03-14,IL,46,316,362,17,Illinois
2020-03-14,IN,15,74,89,18,Indiana
2020-03-14,KS,6,93,99,20,Kansas
2020-03-14,KY,14,139,153,21,Kentucky
2020-03-14,LA,51,109,160,22,Louisiana
2020-03-14,MA,38,NA,38,25,Massachusetts
2020-03-14,MD,26,94,120,24,Maryland
2020-03-14,ME,3,91,94,23,Maine
2020-03-14,MI,1196,205,1401,26,Michigan
2020-03-14,MN,90,847,937,27,Minnesota
2020-03-14,MO,4,90,94,29,Missouri
2020-03-14,MS,6,84,90,28,Mississippi
2020-03-14,MT,5,103,108,30,Montana
2020-03-14,NC,23,137,160,37,North Carolina
2020-03-14,ND,1,54,55,38,North Dakota
2020-03-14,NE,14,80,94,31,Nebraska
2020-03-14,NH,7,212,219,33,New Hampshire
2020-03-14,NJ,50,97,147,34,New Jersey
2020-03-14,NM,10,237,247,35,New Mexico
2020-03-14,NV,20,168,188,32,Nevada
2020-03-14,NY,524,2779,3303,36,New York
2020-03-14,OH,13,50,63,39,Ohio
2020-03-14,OK,4,36,40,40,Oklahoma
2020-03-14,OR,30,337,367,41,Oregon
2020-03-14,PA,47,205,252,42,Pennsylvania
2020-03-14,RI,19,310,329,44,Rhode Island
2020-03-14,SC,13,110,123,45,South Carolina
2020-03-14,SD,9,182,191,46,South Dakota
2020-03-14,TN,32,130,162,47,Tennessee
2020-03-14,TX,51,NA,51,48,Texas
2020-03-14,UT,6,131,137,49,Utah
2020-03-14,VA,30,117,147,51,Virginia
2020-03-14,VT,8,332,340,50,Vermont
2020-03-14,WA,2484,15723,18207,53,Washington
2020-03-14,WI,23,169,192,55,Wisconsin
2020-03-14,WV,0,26,26,54,West Virginia
2020-03-14,WY,2,NA,2,56,Wyoming
2020-03-13,AK,1,59,60,02,Alaska
2020-03-13,AL,1,11,12,01,Alabama
2020-03-13,AR,9,30,39,05,Arkansas
2020-03-13,AZ,9,94,103,04,Arizona
2020-03-13,CA,202,916,1118,06,California
2020-03-13,CO,72,524,596,08,Colorado
2020-03-13,CT,6,99,105,09,Connecticut
2020-03-13,DC,10,20,30,11,District of Columbia
2020-03-13,DE,4,30,34,10,Delaware
2020-03-13,FL,50,478,528,12,Florida
2020-03-13,GA,42,NA,42,13,Georgia
2020-03-13,HI,2,NA,2,15,Hawaii
2020-03-13,IA,16,83,99,19,Iowa
2020-03-13,ID,0,131,131,16,Idaho
2020-03-13,IL,32,294,326,17,Illinois
2020-03-13,IN,12,61,73,18,Indiana
2020-03-13,KS,6,93,99,20,Kansas
2020-03-13,KY,11,107,118,21,Kentucky
2020-03-13,LA,36,37,73,22,Louisiana
2020-03-13,MA,23,NA,23,25,Massachusetts
2020-03-13,MD,17,94,111,24,Maryland
2020-03-13,ME,3,91,94,23,Maine
2020-03-13,MI,945,133,1078,26,Michigan
2020-03-13,MN,62,541,603,27,Minnesota
2020-03-13,MO,2,71,73,29,Missouri
2020-03-13,MS,4,41,45,28,Mississippi
2020-03-13,MT,1,55,56,30,Montana
2020-03-13,NC,15,86,101,37,North Carolina
2020-03-13,ND,1,39,40,38,North Dakota
2020-03-13,NE,13,80,93,31,Nebraska
2020-03-13,NH,6,94,100,33,New Hampshire
2020-03-13,NJ,50,97,147,34,New Jersey
2020-03-13,NM,10,190,200,35,New Mexico
2020-03-13,NV,11,168,179,32,Nevada
2020-03-13,NY,421,2779,3200,36,New York
2020-03-13,OH,13,50,63,39,Ohio
2020-03-13,OK,3,36,39,40,Oklahoma
2020-03-13,OR,30,337,367,41,Oregon
2020-03-13,PA,41,140,181,42,Pennsylvania
2020-03-13,RI,19,224,243,44,Rhode Island
2020-03-13,SC,12,75,87,45,South Carolina
2020-03-13,SD,9,73,82,46,South Dakota
2020-03-13,TN,26,116,142,47,Tennessee
2020-03-13,TX,39,NA,39,48,Texas
2020-03-13,UT,6,131,137,49,Utah
2020-03-13,VA,30,117,147,51,Virginia
2020-03-13,VT,5,223,228,50,Vermont
2020-03-13,WA,2218,13660,15878,53,Washington
2020-03-13,WI,23,169,192,55,Wisconsin
2020-03-13,WV,0,17,17,54,West Virginia
2020-03-13,WY,1,NA,1,56,Wyoming
2020-03-12,AK,0,46,46,02,Alaska
2020-03-12,AL,0,10,10,01,Alabama
2020-03-12,AR,6,24,30,05,Arkansas
2020-03-12,AZ,9,82,91,04,Arizona
2020-03-12,CA,202,916,1118,06,California
2020-03-12,CO,45,298,343,08,Colorado
2020-03-12,CT,6,89,95,09,Connecticut
2020-03-12,DC,10,20,30,11,District of Columbia
2020-03-12,DE,4,23,27,10,Delaware
2020-03-12,FL,32,301,333,12,Florida
2020-03-12,GA,31,NA,31,13,Georgia
2020-03-12,HI,2,NA,2,15,Hawaii
2020-03-12,IA,14,67,81,19,Iowa
2020-03-12,ID,0,93,93,16,Idaho
2020-03-12,IL,25,266,291,17,Illinois
2020-03-12,IN,12,52,64,18,Indiana
2020-03-12,KS,4,41,45,20,Kansas
2020-03-12,KY,8,56,64,21,Kentucky
2020-03-12,LA,14,37,51,22,Louisiana
2020-03-12,MA,8,NA,8,25,Massachusetts
2020-03-12,MD,12,94,106,24,Maryland
2020-03-12,ME,1,65,66,23,Maine
2020-03-12,MI,702,91,793,26,Michigan
2020-03-12,MN,43,307,350,27,Minnesota
2020-03-12,MO,1,64,65,29,Missouri
2020-03-12,MS,1,41,42,28,Mississippi
2020-03-12,MT,1,34,35,30,Montana
2020-03-12,NC,12,60,72,37,North Carolina
2020-03-12,ND,1,12,13,38,North Dakota
2020-03-12,NE,10,80,90,31,Nebraska
2020-03-12,NH,6,94,100,33,New Hampshire
2020-03-12,NJ,30,74,104,34,New Jersey
2020-03-12,NM,5,155,160,35,New Mexico
2020-03-12,NV,7,168,175,32,Nevada
2020-03-12,NY,216,92,308,36,New York
2020-03-12,OH,5,30,35,39,Ohio
2020-03-12,OK,3,36,39,40,Oklahoma
2020-03-12,OR,19,286,305,41,Oregon
2020-03-12,PA,22,116,138,42,Pennsylvania
2020-03-12,RI,13,176,189,44,Rhode Island
2020-03-12,SC,10,48,58,45,South Carolina
2020-03-12,SD,8,27,35,46,South Dakota
2020-03-12,TN,18,79,97,47,Tennessee
2020-03-12,TX,23,NA,23,48,Texas
2020-03-12,UT,4,131,135,49,Utah
2020-03-12,VA,17,117,134,51,Virginia
2020-03-12,VT,2,136,138,50,Vermont
2020-03-12,WA,1921,9723,11644,53,Washington
2020-03-12,WI,9,84,93,55,Wisconsin
2020-03-12,WV,0,7,7,54,West Virginia
2020-03-12,WY,1,NA,1,56,Wyoming
2020-03-11,AK,0,46,46,02,Alaska
2020-03-11,AL,0,10,10,01,Alabama
2020-03-11,AR,0,12,12,05,Arkansas
2020-03-11,AZ,9,59,68,04,Arizona
2020-03-11,CA,157,916,1073,06,California
2020-03-11,CO,28,251,279,08,Colorado
2020-03-11,CT,3,71,74,09,Connecticut
2020-03-11,DC,5,20,25,11,District of Columbia
2020-03-11,DE,1,17,18,10,Delaware
2020-03-11,FL,28,301,329,12,Florida
2020-03-11,GA,22,NA,22,13,Georgia
2020-03-11,HI,2,NA,2,15,Hawaii
2020-03-11,IA,13,46,59,19,Iowa
2020-03-11,ID,0,67,67,16,Idaho
2020-03-11,IL,19,244,263,17,Illinois
2020-03-11,IN,10,33,43,18,Indiana
2020-03-11,KS,1,41,42,20,Kansas
2020-03-11,KY,8,46,54,21,Kentucky
2020-03-11,LA,6,37,43,22,Louisiana
2020-03-11,MD,9,94,103,24,Maryland
2020-03-11,ME,0,42,42,23,Maine
2020-03-11,MI,497,57,554,26,Michigan
2020-03-11,MN,21,217,238,27,Minnesota
2020-03-11,MO,1,NA,1,29,Missouri
2020-03-11,MS,0,20,20,28,Mississippi
2020-03-11,MT,0,21,21,30,Montana
2020-03-11,NC,7,NA,7,37,North Carolina
2020-03-11,ND,0,7,7,38,North Dakota
2020-03-11,NE,5,47,52,31,Nebraska
2020-03-11,NH,4,38,42,33,New Hampshire
2020-03-11,NJ,24,57,81,34,New Jersey
2020-03-11,NM,3,87,90,35,New Mexico
2020-03-11,NV,5,168,173,32,Nevada
2020-03-11,NY,216,92,308,36,New York
2020-03-11,OH,4,21,25,39,Ohio
2020-03-11,OK,2,15,17,40,Oklahoma
2020-03-11,OR,19,286,305,41,Oregon
2020-03-11,PA,16,88,104,42,Pennsylvania
2020-03-11,RI,5,139,144,44,Rhode Island
2020-03-11,SC,9,32,41,45,South Carolina
2020-03-11,SD,5,13,18,46,South Dakota
2020-03-11,TN,7,50,57,47,Tennessee
2020-03-11,TX,21,NA,21,48,Texas
2020-03-11,UT,2,NA,2,49,Utah
2020-03-11,VA,9,60,69,51,Virginia
2020-03-11,VT,2,91,93,50,Vermont
2020-03-11,WA,1665,6215,7880,53,Washington
2020-03-11,WI,3,43,46,55,Wisconsin
2020-03-11,WV,0,3,3,54,West Virginia
2020-03-11,WY,0,NA,0,56,Wyoming
2020-03-10,AK,0,23,23,02,Alaska
2020-03-10,AL,0,0,0,01,Alabama
2020-03-10,AR,0,12,12,05,Arkansas
2020-03-10,AZ,6,51,57,04,Arizona
2020-03-10,CA,133,690,823,06,California
2020-03-10,CO,12,142,154,08,Colorado
2020-03-10,CT,2,54,56,09,Connecticut
2020-03-10,DC,5,17,22,11,District of Columbia
2020-03-10,DE,0,17,17,10,Delaware
2020-03-10,FL,19,222,241,12,Florida
2020-03-10,GA,17,NA,17,13,Georgia
2020-03-10,HI,2,NA,2,15,Hawaii
2020-03-10,IA,8,32,40,19,Iowa
2020-03-10,ID,0,41,41,16,Idaho
2020-03-10,IL,19,244,263,17,Illinois
2020-03-10,IN,6,30,36,18,Indiana
2020-03-10,KS,1,17,18,20,Kansas
2020-03-10,KY,6,28,34,21,Kentucky
2020-03-10,LA,1,11,12,22,Louisiana
2020-03-10,MD,6,89,95,24,Maryland
2020-03-10,ME,0,20,20,23,Maine
2020-03-10,MI,358,39,397,26,Michigan
2020-03-10,MN,11,132,143,27,Minnesota
2020-03-10,MO,1,NA,1,29,Missouri
2020-03-10,MS,0,NA,0,28,Mississippi
2020-03-10,MT,0,15,15,30,Montana
2020-03-10,NC,7,NA,7,37,North Carolina
2020-03-10,ND,0,6,6,38,North Dakota
2020-03-10,NE,3,47,50,31,Nebraska
2020-03-10,NH,4,38,42,33,New Hampshire
2020-03-10,NJ,15,44,59,34,New Jersey
2020-03-10,NM,0,69,69,35,New Mexico
2020-03-10,NV,1,14,15,32,Nevada
2020-03-10,NY,173,92,265,36,New York
2020-03-10,OH,3,14,17,39,Ohio
2020-03-10,OK,2,15,17,40,Oklahoma
2020-03-10,OR,15,213,228,41,Oregon
2020-03-10,PA,12,NA,12,42,Pennsylvania
2020-03-10,RI,5,105,110,44,Rhode Island
2020-03-10,SC,7,24,31,45,South Carolina
2020-03-10,SD,0,11,11,46,South Dakota
2020-03-10,TN,7,NA,7,47,Tennessee
2020-03-10,TX,13,NA,13,48,Texas
2020-03-10,UT,2,NA,2,49,Utah
2020-03-10,VA,8,53,61,51,Virginia
2020-03-10,VT,1,60,61,50,Vermont
2020-03-10,WA,1453,4160,5613,53,Washington
2020-03-10,WI,2,36,38,55,Wisconsin
2020-03-10,WV,0,2,2,54,West Virginia
2020-03-10,WY,0,0,0,56,Wyoming
2020-03-09,AK,0,23,23,02,Alaska
2020-03-09,AL,0,NA,0,01,Alabama
2020-03-09,AR,0,12,12,05,Arkansas
2020-03-09,AZ,5,44,49,04,Arizona
2020-03-09,CA,114,690,804,06,California
2020-03-09,CO,9,133,142,08,Colorado
2020-03-09,CT,1,46,47,09,Connecticut
2020-03-09,DC,1,14,15,11,District of Columbia
2020-03-09,DE,0,15,15,10,Delaware
2020-03-09,FL,18,140,158,12,Florida
2020-03-09,GA,12,NA,12,13,Georgia
2020-03-09,HI,2,NA,2,15,Hawaii
2020-03-09,IA,3,26,29,19,Iowa
2020-03-09,ID,0,41,41,16,Idaho
2020-03-09,IL,7,191,198,17,Illinois
2020-03-09,IN,2,NA,2,18,Indiana
2020-03-09,KS,1,11,12,20,Kansas
2020-03-09,KY,4,17,21,21,Kentucky
2020-03-09,LA,1,5,6,22,Louisiana
2020-03-09,MD,5,73,78,24,Maryland
2020-03-09,ME,0,1,1,23,Maine
2020-03-09,MI,254,36,290,26,Michigan
2020-03-09,MN,5,80,85,27,Minnesota
2020-03-09,MO,1,NA,1,29,Missouri
2020-03-09,MS,0,NA,0,28,Mississippi
2020-03-09,MT,0,11,11,30,Montana
2020-03-09,NC,2,NA,2,37,North Carolina
2020-03-09,ND,0,0,0,38,North Dakota
2020-03-09,NE,3,36,39,31,Nebraska
2020-03-09,NH,4,38,42,33,New Hampshire
2020-03-09,NJ,11,35,46,34,New Jersey
2020-03-09,NM,0,57,57,35,New Mexico
2020-03-09,NV,1,14,15,32,Nevada
2020-03-09,NY,142,92,234,36,New York
2020-03-09,OH,3,11,14,39,Ohio
2020-03-09,OK,1,8,9,40,Oklahoma
2020-03-09,OR,14,165,179,41,Oregon
2020-03-09,PA,10,NA,10,42,Pennsylvania
2020-03-09,RI,4,82,86,44,Rhode Island
2020-03-09,SC,7,24,31,45,South Carolina
2020-03-09,SD,0,5,5,46,South Dakota
2020-03-09,TN,3,NA,3,47,Tennessee
2020-03-09,TX,12,NA,12,48,Texas
2020-03-09,UT,1,NA,1,49,Utah
2020-03-09,VA,3,38,41,51,Virginia
2020-03-09,VT,1,36,37,50,Vermont
2020-03-09,WA,1237,2592,3829,53,Washington
2020-03-09,WI,1,36,37,55,Wisconsin
2020-03-09,WV,0,2,2,54,West Virginia
2020-03-09,WY,0,NA,0,56,Wyoming
2020-03-08,AK,0,14,14,02,Alaska
2020-03-08,AL,0,NA,0,01,Alabama
2020-03-08,AR,0,6,6,05,Arkansas
2020-03-08,AZ,5,44,49,04,Arizona
2020-03-08,CA,88,462,550,06,California
2020-03-08,CO,8,104,112,08,Colorado
2020-03-08,CT,1,29,30,09,Connecticut
2020-03-08,DC,1,10,11,11,District of Columbia
2020-03-08,DE,0,10,10,10,Delaware
2020-03-08,FL,17,118,135,12,Florida
2020-03-08,GA,7,NA,7,13,Georgia
2020-03-08,HI,1,NA,1,15,Hawaii
2020-03-08,IA,0,15,15,19,Iowa
2020-03-08,ID,0,27,27,16,Idaho
2020-03-08,IL,6,191,197,17,Illinois
2020-03-08,IN,2,NA,2,18,Indiana
2020-03-08,KS,1,11,12,20,Kansas
2020-03-08,KY,1,13,14,21,Kentucky
2020-03-08,LA,0,5,5,22,Louisiana
2020-03-08,MD,3,52,55,24,Maryland
2020-03-08,ME,0,1,1,23,Maine
2020-03-08,MI,168,26,194,26,Michigan
2020-03-08,MN,2,48,50,27,Minnesota
2020-03-08,MO,1,NA,1,29,Missouri
2020-03-08,MS,0,NA,0,28,Mississippi
2020-03-08,MT,0,11,11,30,Montana
2020-03-08,NC,2,NA,2,37,North Carolina
2020-03-08,ND,0,0,0,38,North Dakota
2020-03-08,NE,1,17,18,31,Nebraska
2020-03-08,NH,4,38,42,33,New Hampshire
2020-03-08,NJ,6,31,37,34,New Jersey
2020-03-08,NM,0,48,48,35,New Mexico
2020-03-08,NV,1,14,15,32,Nevada
2020-03-08,NY,105,92,197,36,New York
2020-03-08,OH,0,10,10,39,Ohio
2020-03-08,OK,1,8,9,40,Oklahoma
2020-03-08,OR,14,100,114,41,Oregon
2020-03-08,PA,6,NA,6,42,Pennsylvania
2020-03-08,RI,3,67,70,44,Rhode Island
2020-03-08,SC,2,8,10,45,South Carolina
2020-03-08,SD,0,5,5,46,South Dakota
2020-03-08,TN,3,NA,3,47,Tennessee
2020-03-08,TX,8,NA,8,48,Texas
2020-03-08,UT,1,NA,1,49,Utah
2020-03-08,VA,2,36,38,51,Virginia
2020-03-08,VT,1,30,31,50,Vermont
2020-03-08,WA,1065,1740,2805,53,Washington
2020-03-08,WI,1,31,32,55,Wisconsin
2020-03-08,WV,0,2,2,54,West Virginia
2020-03-08,WY,0,NA,0,56,Wyoming
2020-03-07,AK,0,12,12,02,Alaska
2020-03-07,AL,0,NA,0,01,Alabama
2020-03-07,AR,0,6,6,05,Arkansas
2020-03-07,AZ,5,44,49,04,Arizona
2020-03-07,CA,69,462,531,06,California
2020-03-07,CO,8,55,63,08,Colorado
2020-03-07,CT,0,NA,0,09,Connecticut
2020-03-07,DC,0,8,8,11,District of Columbia
2020-03-07,DE,0,10,10,10,Delaware
2020-03-07,FL,14,100,114,12,Florida
2020-03-07,GA,6,NA,6,13,Georgia
2020-03-07,HI,1,NA,1,15,Hawaii
2020-03-07,IA,0,15,15,19,Iowa
2020-03-07,ID,0,27,27,16,Idaho
2020-03-07,IL,6,191,197,17,Illinois
2020-03-07,IN,1,NA,1,18,Indiana
2020-03-07,KS,0,11,11,20,Kansas
2020-03-07,KY,1,9,10,21,Kentucky
2020-03-07,LA,0,NA,0,22,Louisiana
2020-03-07,MD,3,41,44,24,Maryland
2020-03-07,ME,0,1,1,23,Maine
2020-03-07,MI,128,18,146,26,Michigan
2020-03-07,MN,2,48,50,27,Minnesota
2020-03-07,MO,0,NA,0,29,Missouri
2020-03-07,MS,0,NA,0,28,Mississippi
2020-03-07,MT,0,11,11,30,Montana
2020-03-07,NC,2,NA,2,37,North Carolina
2020-03-07,ND,0,0,0,38,North Dakota
2020-03-07,NE,1,17,18,31,Nebraska
2020-03-07,NH,2,20,22,33,New Hampshire
2020-03-07,NJ,4,NA,4,34,New Jersey
2020-03-07,NM,0,48,48,35,New Mexico
2020-03-07,NV,1,14,15,32,Nevada
2020-03-07,NY,76,92,168,36,New York
2020-03-07,OH,0,9,9,39,Ohio
2020-03-07,OK,1,NA,1,40,Oklahoma
2020-03-07,OR,7,77,84,41,Oregon
2020-03-07,PA,4,NA,4,42,Pennsylvania
2020-03-07,RI,3,49,52,44,Rhode Island
2020-03-07,SC,2,8,10,45,South Carolina
2020-03-07,SD,0,5,5,46,South Dakota
2020-03-07,TN,1,NA,1,47,Tennessee
2020-03-07,TX,8,NA,8,48,Texas
2020-03-07,UT,1,NA,1,49,Utah
2020-03-07,VA,0,31,31,51,Virginia
2020-03-07,VT,1,25,26,50,Vermont
2020-03-07,WA,912,1370,2282,53,Washington
2020-03-07,WI,1,31,32,55,Wisconsin
2020-03-07,WV,0,2,2,54,West Virginia
2020-03-07,WY,0,NA,0,56,Wyoming
2020-03-06,AK,0,8,8,02,Alaska
2020-03-06,AR,0,6,6,05,Arkansas
2020-03-06,AZ,3,33,36,04,Arizona
2020-03-06,CA,60,462,522,06,California
2020-03-06,CO,2,46,48,08,Colorado
2020-03-06,DC,0,8,8,11,District of Columbia
2020-03-06,DE,0,10,10,10,Delaware
2020-03-06,FL,9,55,64,12,Florida
2020-03-06,GA,2,NA,2,13,Georgia
2020-03-06,IA,0,15,15,19,Iowa
2020-03-06,IL,5,180,185,17,Illinois
2020-03-06,IN,1,NA,1,18,Indiana
2020-03-06,KS,0,4,4,20,Kansas
2020-03-06,KY,0,7,7,21,Kentucky
2020-03-06,MD,3,26,29,24,Maryland
2020-03-06,MI,98,8,106,26,Michigan
2020-03-06,MN,1,36,37,27,Minnesota
2020-03-06,NC,2,NA,2,37,North Carolina
2020-03-06,NE,0,17,17,31,Nebraska
2020-03-06,NH,2,20,22,33,New Hampshire
2020-03-06,NJ,1,NA,1,34,New Jersey
2020-03-06,NM,0,16,16,35,New Mexico
2020-03-06,NV,1,14,15,32,Nevada
2020-03-06,NY,33,92,125,36,New York
2020-03-06,OH,0,8,8,39,Ohio
2020-03-06,OR,3,64,67,41,Oregon
2020-03-06,PA,2,NA,2,42,Pennsylvania
2020-03-06,RI,3,30,33,44,Rhode Island
2020-03-06,SC,0,5,5,45,South Carolina
2020-03-06,TN,1,NA,1,47,Tennessee
2020-03-06,TX,5,NA,5,48,Texas
2020-03-06,VA,0,21,21,51,Virginia
2020-03-06,VT,0,0,0,50,Vermont
2020-03-06,WA,813,1066,1879,53,Washington
2020-03-06,WI,1,31,32,55,Wisconsin
2020-03-06,WV,0,1,1,54,West Virginia
2020-03-05,AZ,2,28,30,04,Arizona
2020-03-05,CA,53,462,515,06,California
2020-03-05,CO,0,19,19,08,Colorado
2020-03-05,DC,0,6,6,11,District of Columbia
2020-03-05,FL,9,31,40,12,Florida
2020-03-05,GA,2,NA,2,13,Georgia
2020-03-05,IL,5,165,170,17,Illinois
2020-03-05,MD,0,17,17,24,Maryland
2020-03-05,MI,72,8,80,26,Michigan
2020-03-05,NC,1,NA,1,37,North Carolina
2020-03-05,NE,0,17,17,31,Nebraska
2020-03-05,NH,2,16,18,33,New Hampshire
2020-03-05,NJ,1,NA,1,34,New Jersey
2020-03-05,NV,1,14,15,32,Nevada
2020-03-05,NY,22,76,98,36,New York
2020-03-05,OH,0,7,7,39,Ohio
2020-03-05,OR,3,45,48,41,Oregon
2020-03-05,RI,3,19,22,44,Rhode Island
2020-03-05,SC,0,5,5,45,South Carolina
2020-03-05,TN,1,NA,1,47,Tennessee
2020-03-05,TX,1,NA,1,48,Texas
2020-03-05,VA,0,18,18,51,Virginia
2020-03-05,WA,731,672,1403,53,Washington
2020-03-05,WI,1,19,20,55,Wisconsin
2020-03-04,AZ,2,27,29,04,Arizona
2020-03-04,CA,53,462,515,06,California
2020-03-04,FL,2,24,26,12,Florida
2020-03-04,GA,2,NA,2,13,Georgia
2020-03-04,IL,4,124,128,17,Illinois
2020-03-04,MI,52,NA,52,26,Michigan
2020-03-04,NC,1,NA,1,37,North Carolina
2020-03-04,NH,2,10,12,33,New Hampshire
2020-03-04,NY,6,48,54,36,New York
2020-03-04,OR,3,29,32,41,Oregon
2020-03-04,RI,2,15,17,44,Rhode Island
2020-03-04,SC,0,5,5,45,South Carolina
2020-03-04,TX,1,NA,1,48,Texas
2020-03-04,WA,626,417,1043,53,Washington
2020-03-04,WI,1,19,20,55,Wisconsin
2020-03-03,MI,34,NA,34,26,Michigan
2020-03-03,RI,2,5,7,44,Rhode Island
2020-03-03,WA,534,264,798,53,Washington
2020-03-02,MI,18,NA,18,26,Michigan
2020-03-02,RI,2,3,5,44,Rhode Island
2020-03-02,WA,450,123,573,53,Washington
2020-03-01,MI,9,NA,9,26,Michigan
2020-03-01,RI,2,2,4,44,Rhode Island
2020-03-01,WA,377,12,389,53,Washington
2020-02-29,WA,299,17,316,53,Washington
2020-02-28,WA,275,0,275,53,Washington
2020-02-27,WA,235,0,235,53,Washington
2020-02-26,WA,208,0,208,53,Washington
2020-02-25,WA,179,0,179,53,Washington
2020-02-24,WA,148,0,148,53,Washington
2020-02-23,WA,122,0,122,53,Washington
2020-02-22,WA,106,0,106,53,Washington
2020-02-21,WA,93,0,93,53,Washington
2020-02-20,WA,82,0,82,53,Washington
2020-02-19,WA,69,0,69,53,Washington
2020-02-18,WA,59,0,59,53,Washington
2020-02-17,WA,50,0,50,53,Washington
2020-02-16,WA,35,0,35,53,Washington
2020-02-15,WA,28,0,28,53,Washington
2020-02-14,WA,21,0,21,53,Washington
2020-02-13,WA,18,0,18,53,Washington
2020-02-12,WA,18,0,18,53,Washington
2020-02-11,WA,17,0,17,53,Washington
2020-02-10,WA,16,0,16,53,Washington
2020-02-09,WA,13,0,13,53,Washington
2020-02-08,WA,13,0,13,53,Washington
2020-02-07,WA,12,0,12,53,Washington
2020-02-06,WA,11,0,11,53,Washington
2020-02-05,WA,8,0,8,53,Washington
2020-02-04,WA,8,0,8,53,Washington
2020-02-03,WA,7,0,7,53,Washington
2020-02-02,WA,6,0,6,53,Washington
2020-02-01,WA,4,0,4,53,Washington
2020-01-31,WA,3,0,3,53,Washington
2020-01-30,WA,3,0,3,53,Washington
2020-01-29,WA,3,0,3,53,Washington
2020-01-28,WA,2,0,2,53,Washington
2020-01-27,WA,2,0,2,53,Washington
2020-01-26,WA,2,0,2,53,Washington
2020-01-25,WA,2,0,2,53,Washington
2020-01-24,WA,2,0,2,53,Washington
2020-01-23,WA,2,0,2,53,Washington
2020-01-22,WA,2,0,2,53,Washington
