date,state_abbrev,positive,negative,total,state_code,state
2020-06-16,AK,676,75539,76215,02,Alaska
2020-06-16,AL,26912,278512,305424,01,Alabama
2020-06-16,AR,13191,192375,205566,05,Arkansas
2020-06-16,AS,0,174,174,60,American Samoa
2020-06-16,AZ,39097,315237,354334,04,Arizona
2020-06-16,CA,153560,2784195,2937755,06,California
2020-06-16,CO,29299,223857,253156,08,Colorado
2020-06-16,CT,45349,316071,361420,09,Connecticut
2020-06-16,DC,9818,57308,67126,11,District of Columbia
2020-06-16,DE,10403,75671,86074,10,Delaware
2020-06-16,FL,80109,1380200,1460309,12,Florida
2020-06-16,GA,59078,575900,634978,13,Georgia
2020-06-16,GU,186,8846,9032,66,Guam
2020-06-16,HI,736,61292,62028,15,Hawaii
2020-06-16,IA,24179,206459,230638,19,Iowa
2020-06-16,ID,3462,62185,65647,16,Idaho
2020-06-16,IL,134500,1094702,1229202,17,Illinois
2020-06-16,IN,40786,322959,363745,18,Indiana
2020-06-16,KS,11419,125543,136962,20,Kansas
2020-06-16,KY,12829,283204,296033,21,Kentucky
2020-06-16,LA,47706,485011,532717,22,Louisiana
2020-06-16,MA,105885,617762,723647,25,Massachusetts
2020-06-16,MD,62409,366816,429225,24,Maryland
2020-06-16,ME,2819,69516,72335,23,Maine
2020-06-16,MI,66269,769265,835534,26,Michigan
2020-06-16,MN,30882,398263,429145,27,Minnesota
2020-06-16,MO,16414,268377,284791,29,Missouri
2020-06-16,MP,30,8139,8169,69,Northern Mariana Islands
2020-06-16,MS,20152,220651,240803,28,Mississippi
2020-06-16,MT,614,62963,63577,30,Montana
2020-06-16,NC,45853,605568,651421,37,North Carolina
2020-06-16,ND,3124,85527,88651,38,North Dakota
2020-06-16,NE,16851,122662,139513,31,Nebraska
2020-06-16,NH,5345,93528,98873,33,New Hampshire
2020-06-16,NJ,167426,964356,1131782,34,New Jersey
2020-06-16,NM,9845,258076,267921,35,New Mexico
2020-06-16,NV,11658,210816,222474,32,Nevada
2020-06-16,NY,384575,2667203,3051778,36,New York
2020-06-16,OH,42010,526123,568133,39,Ohio
2020-06-16,OK,8645,253160,261805,40,Oklahoma
2020-06-16,OR,6098,173440,179538,41,Oregon
2020-06-16,PA,79483,523609,603092,42,Pennsylvania
2020-06-16,PR,5951,NA,5951,72,Puerto Rico
2020-06-16,RI,16164,187454,203618,44,Rhode Island
2020-06-16,SC,19990,247689,267679,45,South Carolina
2020-06-16,SD,5966,61236,67202,46,South Dakota
2020-06-16,TN,31830,607160,638990,47,Tennessee
2020-06-16,TX,93206,1255236,1348442,48,Texas
2020-06-16,UT,14937,260763,275700,49,Utah
2020-06-16,VA,55331,430107,485438,51,Virginia
2020-06-16,VI,73,2305,2378,78,U.S. Virgin Islands
2020-06-16,VT,1131,51759,52890,50,Vermont
2020-06-16,WA,26158,445107,471265,53,Washington
2020-06-16,WI,23198,414330,437528,55,Wisconsin
2020-06-16,WV,2341,134730,137071,54,West Virginia
2020-06-16,WY,1089,33324,34413,56,Wyoming
2020-06-15,AK,664,73773,74437,02,Alaska
2020-06-15,AL,26272,276402,302674,01,Alabama
2020-06-15,AR,12917,191221,204138,05,Arkansas
2020-06-15,AS,0,174,174,60,American Samoa
2020-06-15,AZ,36705,308552,345257,04,Arizona
2020-06-15,CA,151452,2716730,2868182,06,California
2020-06-15,CO,29130,219955,249085,08,Colorado
2020-06-15,CT,45235,311142,356377,09,Connecticut
2020-06-15,DC,9799,56047,65846,11,District of Columbia
2020-06-15,DE,10340,74346,84686,10,Delaware
2020-06-15,FL,77326,1352858,1430184,12,Florida
2020-06-15,GA,58414,572082,630496,13,Georgia
2020-06-15,GU,185,8573,8758,66,Guam
2020-06-15,HI,728,60746,61474,15,Hawaii
2020-06-15,IA,24053,203335,227388,19,Iowa
2020-06-15,ID,3399,59581,62980,16,Idaho
2020-06-15,IL,133877,1076596,1210473,17,Illinois
2020-06-15,IN,40430,315399,355829,18,Indiana
2020-06-15,KS,11419,125543,136962,20,Kansas
2020-06-15,KY,12647,283204,295851,21,Kentucky
2020-06-15,LA,47172,471553,518725,22,Louisiana
2020-06-15,MA,105690,611541,717231,25,Massachusetts
2020-06-15,MD,62032,359076,421108,24,Maryland
2020-06-15,ME,2810,68161,70971,23,Maine
2020-06-15,MI,66085,757952,824037,26,Michigan
2020-06-15,MN,30693,392229,422922,27,Minnesota
2020-06-15,MO,16189,263752,279941,29,Missouri
2020-06-15,MP,30,8139,8169,69,Northern Mariana Islands
2020-06-15,MS,19799,210704,230503,28,Mississippi
2020-06-15,MT,609,60328,60937,30,Montana
2020-06-15,NC,45102,593377,638479,37,North Carolina
2020-06-15,ND,3101,84675,87776,38,North Dakota
2020-06-15,NE,16725,121030,137755,31,Nebraska
2020-06-15,NH,5345,93528,98873,33,New Hampshire
2020-06-15,NJ,167103,948980,1116083,34,New Jersey
2020-06-15,NM,9723,253942,263665,35,New Mexico
2020-06-15,NV,11279,205155,216434,32,Nevada
2020-06-15,NY,383944,2607266,2991210,36,New York
2020-06-15,OH,41576,515592,557168,39,Ohio
2020-06-15,OK,8417,242587,251004,40,Oklahoma
2020-06-15,OR,5636,168246,173882,41,Oregon
2020-06-15,PA,79121,513909,593030,42,Pennsylvania
2020-06-15,PR,5890,NA,5890,72,Puerto Rico
2020-06-15,RI,16093,184352,200445,44,Rhode Island
2020-06-15,SC,19378,236179,255557,45,South Carolina
2020-06-15,SD,5928,60467,66395,46,South Dakota
2020-06-15,TN,31160,598818,629978,47,Tennessee
2020-06-15,TX,89108,1225653,1314761,48,Texas
2020-06-15,UT,14608,258330,272938,49,Utah
2020-06-15,VA,54886,424113,478999,51,Virginia
2020-06-15,VI,73,2305,2378,78,U.S. Virgin Islands
2020-06-15,VT,1128,51429,52557,50,Vermont
2020-06-15,WA,25834,436768,462602,53,Washington
2020-06-15,WI,22932,403447,426379,55,Wisconsin
2020-06-15,WV,2298,129655,131953,54,West Virginia
2020-06-15,WY,1060,31546,32606,56,Wyoming
2020-06-14,AK,661,72806,73467,02,Alaska
2020-06-14,AL,25615,271840,297455,01,Alabama
2020-06-14,AR,12501,184488,196989,05,Arkansas
2020-06-14,AS,0,174,174,60,American Samoa
2020-06-14,AZ,35691,302354,338045,04,Arizona
2020-06-14,CA,148855,2653141,2801996,06,California
2020-06-14,CO,29017,215626,244643,08,Colorado
2020-06-14,CT,45088,304018,349106,09,Connecticut
2020-06-14,DC,9767,54763,64530,11,District of Columbia
2020-06-14,DE,10264,71523,81787,10,Delaware
2020-06-14,FL,75568,1333447,1409015,12,Florida
2020-06-14,GA,57681,563109,620790,13,Georgia
2020-06-14,GU,185,8358,8543,66,Guam
2020-06-14,HI,723,59599,60322,15,Hawaii
2020-06-14,IA,23926,200708,224634,19,Iowa
2020-06-14,ID,3399,59581,62980,16,Idaho
2020-06-14,IL,133404,1058442,1191846,17,Illinois
2020-06-14,IN,39909,308482,348391,18,Indiana
2020-06-14,KS,11047,118105,129152,20,Kansas
2020-06-14,KY,12445,282140,294585,21,Kentucky
2020-06-14,LA,46619,462713,509332,22,Louisiana
2020-06-14,MA,105603,607107,712710,25,Massachusetts
2020-06-14,MD,61701,353608,415309,24,Maryland
2020-06-14,ME,2793,67065,69858,23,Maine
2020-06-14,MI,66054,747444,813498,26,Michigan
2020-06-14,MN,30471,387239,417710,27,Minnesota
2020-06-14,MO,15810,259679,275489,29,Missouri
2020-06-14,MP,30,8139,8169,69,Northern Mariana Islands
2020-06-14,MS,19516,194537,214053,28,Mississippi
2020-06-14,MT,601,58306,58907,30,Montana
2020-06-14,NC,44119,583011,627130,37,North Carolina
2020-06-14,ND,3080,83800,86880,38,North Dakota
2020-06-14,NE,16633,119482,136115,31,Nebraska
2020-06-14,NH,5299,91122,96421,33,New Hampshire
2020-06-14,NJ,166881,930735,1097616,34,New Jersey
2020-06-14,NM,9621,249373,258994,35,New Mexico
2020-06-14,NV,11173,199438,210611,32,Nevada
2020-06-14,NY,383324,2551275,2934599,36,New York
2020-06-14,OH,41148,505072,546220,39,Ohio
2020-06-14,OK,8231,242587,250818,40,Oklahoma
2020-06-14,OR,5377,160812,166189,41,Oregon
2020-06-14,PA,78798,504435,583233,42,Pennsylvania
2020-06-14,PR,5811,NA,5811,72,Puerto Rico
2020-06-14,RI,15947,175571,191518,44,Rhode Island
2020-06-14,SC,18795,229541,248336,45,South Carolina
2020-06-14,SD,5898,59421,65319,46,South Dakota
2020-06-14,TN,30432,584788,615220,47,Tennessee
2020-06-14,TX,87854,1208129,1295983,48,Texas
2020-06-14,UT,14313,253400,267713,49,Utah
2020-06-14,VA,54506,414494,469000,51,Virginia
2020-06-14,VI,72,2305,2377,78,U.S. Virgin Islands
2020-06-14,VT,1127,49855,50982,50,Vermont
2020-06-14,WA,25538,424608,450146,53,Washington
2020-06-14,WI,22758,397366,420124,55,Wisconsin
2020-06-14,WV,2289,128910,131199,54,West Virginia
2020-06-14,WY,1060,32005,33065,56,Wyoming
2020-06-13,AK,654,71149,71803,02,Alaska
2020-06-13,AL,24601,268651,293252,01,Alabama
2020-06-13,AR,11547,175470,187017,05,Arkansas
2020-06-13,AS,0,174,174,60,American Samoa
2020-06-13,AZ,34458,293939,328397,04,Arizona
2020-06-13,CA,145643,2578750,2724393,06,California
2020-06-13,CO,28822,207639,236461,08,Colorado
2020-06-13,CT,44994,299260,344254,09,Connecticut
2020-06-13,DC,9709,53327,63036,11,District of Columbia
2020-06-13,DE,10229,69870,80099,10,Delaware
2020-06-13,FL,73552,1296861,1370413,12,Florida
2020-06-13,GA,56801,542879,599680,13,Georgia
2020-06-13,GU,185,8358,8543,66,Guam
2020-06-13,HI,706,58632,59338,15,Hawaii
2020-06-13,IA,23717,195891,219608,19,Iowa
2020-06-13,ID,3353,59305,62658,16,Idaho
2020-06-13,IL,132732,1037074,1169806,17,Illinois
2020-06-13,IN,39543,301094,340637,18,Indiana
2020-06-13,KS,11047,118105,129152,20,Kansas
2020-06-13,KY,12445,282140,294585,21,Kentucky
2020-06-13,LA,46283,458100,504383,22,Louisiana
2020-06-13,MA,105395,598201,703596,25,Massachusetts
2020-06-13,MD,61305,347453,408758,24,Maryland
2020-06-13,ME,2757,65593,68350,23,Maine
2020-06-13,MI,65836,733647,799483,26,Michigan
2020-06-13,MN,30465,387245,417710,27,Minnesota
2020-06-13,MO,15810,253986,269796,29,Missouri
2020-06-13,MP,30,7906,7936,69,Northern Mariana Islands
2020-06-13,MS,19348,194537,213885,28,Mississippi
2020-06-13,MT,588,57416,58004,30,Montana
2020-06-13,NC,42676,569014,611690,37,North Carolina
2020-06-13,ND,3058,82815,85873,38,North Dakota
2020-06-13,NE,16513,117864,134377,31,Nebraska
2020-06-13,NH,5251,88705,93956,33,New Hampshire
2020-06-13,NJ,166605,911610,1078215,34,New Jersey
2020-06-13,NM,9526,245758,255284,35,New Mexico
2020-06-13,NV,10946,193934,204880,32,Nevada
2020-06-13,NY,382630,2489610,2872240,36,New York
2020-06-13,OH,40848,498050,538898,39,Ohio
2020-06-13,OK,8073,238366,246439,40,Oklahoma
2020-06-13,OR,5377,160812,166189,41,Oregon
2020-06-13,PA,78462,496589,575051,42,Pennsylvania
2020-06-13,PR,5690,NA,5690,72,Puerto Rico
2020-06-13,RI,15947,175571,191518,44,Rhode Island
2020-06-13,SC,17955,223951,241906,45,South Carolina
2020-06-13,SD,5833,58680,64513,46,South Dakota
2020-06-13,TN,29541,571821,601362,47,Tennessee
2020-06-13,TX,86011,1174308,1260319,48,Texas
2020-06-13,UT,13981,248801,262782,49,Utah
2020-06-13,VA,53869,406124,459993,51,Virginia
2020-06-13,VI,72,2284,2356,78,U.S. Virgin Islands
2020-06-13,VT,1125,48808,49933,50,Vermont
2020-06-13,WA,25171,414691,439862,53,Washington
2020-06-13,WI,22518,388399,410917,55,Wisconsin
2020-06-13,WV,2259,125258,127517,54,West Virginia
2020-06-13,WY,1050,32005,33055,56,Wyoming
2020-06-12,AK,625,70255,70880,02,Alaska
2020-06-12,AL,23710,262675,286385,01,Alabama
2020-06-12,AR,11547,169575,181122,05,Arkansas
2020-06-12,AS,0,174,174,60,American Samoa
2020-06-12,AZ,32918,278318,311236,04,Arizona
2020-06-12,CA,141983,2520275,2662258,06,California
2020-06-12,CO,28647,205723,234370,08,Colorado
2020-06-12,CT,44689,285565,330254,09,Connecticut
2020-06-12,DC,9654,52299,61953,11,District of Columbia
2020-06-12,DE,10173,67521,77694,10,Delaware
2020-06-12,FL,70971,1264928,1335899,12,Florida
2020-06-12,GA,55783,536175,591958,13,Georgia
2020-06-12,GU,184,8343,8527,66,Guam
2020-06-12,HI,692,57887,58579,15,Hawaii
2020-06-12,IA,23337,191207,214544,19,Iowa
2020-06-12,ID,3302,58130,61432,16,Idaho
2020-06-12,IL,132059,1015903,1147962,17,Illinois
2020-06-12,IN,39146,296034,335180,18,Indiana
2020-06-12,KS,11047,118105,129152,20,Kansas
2020-06-12,KY,11945,269149,281094,21,Kentucky
2020-06-12,LA,44995,434539,479534,22,Louisiana
2020-06-12,MA,105059,588300,693359,25,Massachusetts
2020-06-12,MD,60613,339482,400095,24,Maryland
2020-06-12,ME,2721,64166,66887,23,Maine
2020-06-12,MI,65672,720615,786287,26,Michigan
2020-06-12,MN,30463,377589,408052,27,Minnesota
2020-06-12,MO,15585,249550,265135,29,Missouri
2020-06-12,MP,30,7732,7762,69,Northern Mariana Islands
2020-06-12,MS,19091,195402,214493,28,Mississippi
2020-06-12,MT,573,56449,57022,30,Montana
2020-06-12,NC,41249,554448,595697,37,North Carolina
2020-06-12,ND,3016,81148,84164,38,North Dakota
2020-06-12,NE,16315,114458,130773,31,Nebraska
2020-06-12,NH,5209,86708,91917,33,New Hampshire
2020-06-12,NJ,166164,889232,1055396,34,New Jersey
2020-06-12,NM,9526,245758,255284,35,New Mexico
2020-06-12,NV,10678,188769,199447,32,Nevada
2020-06-12,NY,381714,2419686,2801400,36,New York
2020-06-12,OH,40424,483294,523718,39,Ohio
2020-06-12,OK,7848,238366,246214,40,Oklahoma
2020-06-12,OR,5377,160812,166189,41,Oregon
2020-06-12,PA,77999,488385,566384,42,Pennsylvania
2020-06-12,PR,5536,NA,5536,72,Puerto Rico
2020-06-12,RI,15947,175571,191518,44,Rhode Island
2020-06-12,SC,17170,218889,236059,45,South Carolina
2020-06-12,SD,5742,57263,63005,46,South Dakota
2020-06-12,TN,29126,561047,590173,47,Tennessee
2020-06-12,TX,83680,1143277,1226957,48,Texas
2020-06-12,UT,13577,245209,258786,49,Utah
2020-06-12,VA,53211,397319,450530,51,Virginia
2020-06-12,VI,72,2221,2293,78,U.S. Virgin Islands
2020-06-12,VT,1119,47515,48634,50,Vermont
2020-06-12,WA,24779,400433,425212,53,Washington
2020-06-12,WI,22246,377362,399608,55,Wisconsin
2020-06-12,WV,2233,121806,124039,54,West Virginia
2020-06-12,WY,1027,30873,31900,56,Wyoming
2020-06-11,AK,611,68400,69011,02,Alaska
2020-06-11,AL,22845,255981,278826,01,Alabama
2020-06-11,AR,10816,165849,176665,05,Arkansas
2020-06-11,AS,0,174,174,60,American Samoa
2020-06-11,AZ,31264,278318,309582,04,Arizona
2020-06-11,CA,139281,2458366,2597647,06,California
2020-06-11,CO,28499,201846,230345,08,Colorado
2020-06-11,CT,44461,277487,321948,09,Connecticut
2020-06-11,DC,9589,49699,59288,11,District of Columbia
2020-06-11,DE,10106,63927,74033,10,Delaware
2020-06-11,FL,69069,1237679,1306748,12,Florida
2020-06-11,GA,54973,529268,584241,13,Georgia
2020-06-11,GU,183,8197,8380,66,Guam
2020-06-11,HI,685,56610,57295,15,Hawaii
2020-06-11,IA,22938,185601,208539,19,Iowa
2020-06-11,ID,3260,56855,60115,16,Idaho
2020-06-11,IL,131327,991724,1123051,17,Illinois
2020-06-11,IN,38748,288594,327342,18,Indiana
2020-06-11,KS,10812,112930,123742,20,Kansas
2020-06-11,KY,11945,269149,281094,21,Kentucky
2020-06-11,LA,44472,425201,469673,22,Louisiana
2020-06-11,MA,104667,578421,683088,25,Massachusetts
2020-06-11,MD,60197,332173,392370,24,Maryland
2020-06-11,ME,2667,62790,65457,23,Maine
2020-06-11,MI,65449,705071,770520,26,Michigan
2020-06-11,MN,30418,364816,395234,27,Minnesota
2020-06-11,MO,15390,243650,259040,29,Missouri
2020-06-11,MP,30,7551,7581,69,Northern Mariana Islands
2020-06-11,MS,18483,195402,213885,28,Mississippi
2020-06-11,MT,563,55214,55777,30,Montana
2020-06-11,NC,39481,533196,572677,37,North Carolina
2020-06-11,ND,2980,79808,82788,38,North Dakota
2020-06-11,NE,16025,111637,127662,31,Nebraska
2020-06-11,NH,5178,84729,89907,33,New Hampshire
2020-06-11,NJ,165816,864977,1030793,34,New Jersey
2020-06-11,NM,9250,236307,245557,35,New Mexico
2020-06-11,NV,10399,182855,193254,32,Nevada
2020-06-11,NY,380892,2348113,2729005,36,New York
2020-06-11,OH,40004,472579,512583,39,Ohio
2020-06-11,OK,7626,233819,241445,40,Oklahoma
2020-06-11,OR,5237,156567,161804,41,Oregon
2020-06-11,PA,77933,476439,554372,42,Pennsylvania
2020-06-11,PR,5352,NA,5352,72,Puerto Rico
2020-06-11,RI,15862,171941,187803,44,Rhode Island
2020-06-11,SC,16441,213616,230057,45,South Carolina
2020-06-11,SD,5665,56079,61744,46,South Dakota
2020-06-11,TN,28538,506756,535294,47,Tennessee
2020-06-11,TX,81583,1124737,1206320,48,Texas
2020-06-11,UT,13252,241416,254668,49,Utah
2020-06-11,VA,52647,354750,407397,51,Virginia
2020-06-11,VI,72,2180,2252,78,U.S. Virgin Islands
2020-06-11,VT,1110,46099,47209,50,Vermont
2020-06-11,WA,24642,390700,415342,53,Washington
2020-06-11,WI,21926,366054,387980,55,Wisconsin
2020-06-11,WV,2212,118908,121120,54,West Virginia
2020-06-11,WY,1009,30609,31618,56,Wyoming
2020-06-10,AK,593,67127,67720,02,Alaska
2020-06-10,AL,21989,251068,273057,01,Alabama
2020-06-10,AR,10368,165849,176217,05,Arkansas
2020-06-10,AS,0,174,174,60,American Samoa
2020-06-10,AZ,29852,269835,299687,04,Arizona
2020-06-10,CA,136191,2404607,2540798,06,California
2020-06-10,CO,28347,197747,226094,08,Colorado
2020-06-10,CT,44347,272566,316913,09,Connecticut
2020-06-10,DC,9537,48655,58192,11,District of Columbia
2020-06-10,DE,10056,61689,71745,10,Delaware
2020-06-10,FL,67371,1211652,1279023,12,Florida
2020-06-10,GA,53980,516975,570955,13,Georgia
2020-06-10,GU,182,8100,8282,66,Guam
2020-06-10,HI,682,55491,56173,15,Hawaii
2020-06-10,IA,22551,180278,202829,19,Iowa
2020-06-10,ID,3220,55832,59052,16,Idaho
2020-06-10,IL,130561,970165,1100726,17,Illinois
2020-06-10,IN,38337,281757,320094,18,Indiana
2020-06-10,KS,10812,112930,123742,20,Kansas
2020-06-10,KY,11883,262531,274414,21,Kentucky
2020-06-10,LA,44030,416090,460120,22,Louisiana
2020-06-10,MA,104156,567934,672090,25,Massachusetts
2020-06-10,MD,59465,325177,384642,24,Maryland
2020-06-10,ME,2637,61303,63940,23,Maine
2020-06-10,MI,65182,690869,756051,26,Michigan
2020-06-10,MN,30199,351634,381833,27,Minnesota
2020-06-10,MO,15187,236442,251629,29,Missouri
2020-06-10,MP,30,7493,7523,69,Northern Mariana Islands
2020-06-10,MS,18483,195402,213885,28,Mississippi
2020-06-10,MT,561,54055,54616,30,Montana
2020-06-10,NC,38171,515479,553650,37,North Carolina
2020-06-10,ND,2941,78719,81660,38,North Dakota
2020-06-10,NE,15883,109279,125162,31,Nebraska
2020-06-10,NH,5132,83515,88647,33,New Hampshire
2020-06-10,NJ,165346,843588,1008934,34,New Jersey
2020-06-10,NM,9105,232552,241657,35,New Mexico
2020-06-10,NV,10164,177159,187323,32,Nevada
2020-06-10,NY,380156,2288010,2668166,36,New York
2020-06-10,OH,39575,462309,501884,39,Ohio
2020-06-10,OK,7480,229817,237297,40,Oklahoma
2020-06-10,OR,5060,151698,156758,41,Oregon
2020-06-10,PA,77466,466964,544430,42,Pennsylvania
2020-06-10,PR,5329,NA,5329,72,Puerto Rico
2020-06-10,RI,15756,167866,183622,44,Rhode Island
2020-06-10,SC,15759,236773,252532,45,South Carolina
2020-06-10,SD,5604,55081,60685,46,South Dakota
2020-06-10,TN,28061,500766,528827,47,Tennessee
2020-06-10,TX,79757,1081330,1161087,48,Texas
2020-06-10,UT,12864,236896,249760,49,Utah
2020-06-10,VA,52177,346187,398364,51,Virginia
2020-06-10,VI,72,2169,2241,78,U.S. Virgin Islands
2020-06-10,VT,1095,44647,45742,50,Vermont
2020-06-10,WA,24354,390700,415054,53,Washington
2020-06-10,WI,21593,357112,378705,55,Wisconsin
2020-06-10,WV,2188,115802,117990,54,West Virginia
2020-06-10,WY,980,29872,30852,56,Wyoming
2020-06-09,AK,573,66317,66890,02,Alaska
2020-06-09,AL,21422,246317,267739,01,Alabama
2020-06-09,AR,10080,155701,165781,05,Arkansas
2020-06-09,AS,0,174,174,60,American Samoa
2020-06-09,AZ,28296,264917,293213,04,Arizona
2020-06-09,CA,133489,2352756,2486245,06,California
2020-06-09,CO,28183,193704,221887,08,Colorado
2020-06-09,CT,44179,268472,312651,09,Connecticut
2020-06-09,DC,9474,47678,57152,11,District of Columbia
2020-06-09,DE,10020,60733,70753,10,Delaware
2020-06-09,FL,66000,1192305,1258305,12,Florida
2020-06-09,GA,53249,503934,557183,13,Georgia
2020-06-09,GU,180,7796,7976,66,Guam
2020-06-09,HI,676,54798,55474,15,Hawaii
2020-06-09,IA,22236,175487,197723,19,Iowa
2020-06-09,ID,3189,54488,57677,16,Idaho
2020-06-09,IL,129936,949970,1079906,17,Illinois
2020-06-09,IN,38033,277357,315390,18,Indiana
2020-06-09,KS,10650,108859,119509,20,Kansas
2020-06-09,KY,11708,248230,259938,21,Kentucky
2020-06-09,LA,43612,410056,453668,22,Louisiana
2020-06-09,MA,103889,558103,661992,25,Massachusetts
2020-06-09,MD,58904,319178,378082,24,Maryland
2020-06-09,ME,2606,59814,62420,23,Maine
2020-06-09,MI,65167,690869,756036,26,Michigan
2020-06-09,MN,29866,339927,369793,27,Minnesota
2020-06-09,MO,14913,230782,245695,29,Missouri
2020-06-09,MP,30,7493,7523,69,Northern Mariana Islands
2020-06-09,MS,17768,190444,208212,28,Mississippi
2020-06-09,MT,554,52630,53184,30,Montana
2020-06-09,NC,37160,498551,535711,37,North Carolina
2020-06-09,ND,2901,77765,80666,38,North Dakota
2020-06-09,NE,15752,106940,122692,31,Nebraska
2020-06-09,NH,5079,82044,87123,33,New Hampshire
2020-06-09,NJ,164796,824701,989497,34,New Jersey
2020-06-09,NM,9062,229739,238801,35,New Mexico
2020-06-09,NV,10030,173559,183589,32,Nevada
2020-06-09,NY,379482,2226387,2605869,36,New York
2020-06-09,OH,39162,451228,490390,39,Ohio
2020-06-09,OK,7363,226678,234041,40,Oklahoma
2020-06-09,OR,4988,148629,153617,41,Oregon
2020-06-09,PA,77056,459248,536304,42,Pennsylvania
2020-06-09,PR,5185,NA,5185,72,Puerto Rico
2020-06-09,RI,15691,165196,180887,44,Rhode Island
2020-06-09,SC,15228,232754,247982,45,South Carolina
2020-06-09,SD,5523,53636,59159,46,South Dakota
2020-06-09,TN,27575,493622,521197,47,Tennessee
2020-06-09,TX,77253,1070102,1147355,48,Texas
2020-06-09,UT,12559,234301,246860,49,Utah
2020-06-09,VA,51738,339118,390856,51,Virginia
2020-06-09,VI,71,2137,2208,78,U.S. Virgin Islands
2020-06-09,VT,1084,43144,44228,50,Vermont
2020-06-09,WA,24041,386249,410290,53,Washington
2020-06-09,WI,21308,347210,368518,55,Wisconsin
2020-06-09,WV,2169,112169,114338,54,West Virginia
2020-06-09,WY,970,29366,30336,56,Wyoming
2020-06-08,AK,563,65349,65912,02,Alaska
2020-06-08,AL,20925,239066,259991,01,Alabama
2020-06-08,AR,9740,150847,160587,05,Arkansas
2020-06-08,AS,0,174,174,60,American Samoa
2020-06-08,AZ,27678,260403,288081,04,Arizona
2020-06-08,CA,131319,2299871,2431190,06,California
2020-06-08,CO,28001,189483,217484,08,Colorado
2020-06-08,CT,44092,263979,308071,09,Connecticut
2020-06-08,DC,9389,46377,55766,11,District of Columbia
2020-06-08,DE,9972,59975,69947,10,Delaware
2020-06-08,FL,64904,1169646,1234550,12,Florida
2020-06-08,GA,52497,496878,549375,13,Georgia
2020-06-08,GU,179,7550,7729,66,Guam
2020-06-08,HI,675,54472,55147,15,Hawaii
2020-06-08,IA,21987,171635,193622,19,Iowa
2020-06-08,ID,3139,52902,56041,16,Idaho
2020-06-08,IL,129139,930458,1059597,17,Illinois
2020-06-08,IN,37623,271880,309503,18,Indiana
2020-06-08,KS,10650,108859,119509,20,Kansas
2020-06-08,KY,11476,241381,252857,21,Kentucky
2020-06-08,LA,43050,399552,442602,22,Louisiana
2020-06-08,MA,103626,553643,657269,25,Massachusetts
2020-06-08,MD,58404,313099,371503,24,Maryland
2020-06-08,ME,2588,59057,61645,23,Maine
2020-06-08,MI,65104,674060,739164,26,Michigan
2020-06-08,MN,29436,331476,360912,27,Minnesota
2020-06-08,MO,14734,226727,241461,29,Missouri
2020-06-08,MP,28,7214,7242,69,Northern Mariana Islands
2020-06-08,MS,17768,190444,208212,28,Mississippi
2020-06-08,MT,548,51044,51592,30,Montana
2020-06-08,NC,36484,483629,520113,37,North Carolina
2020-06-08,ND,2880,77300,80180,38,North Dakota
2020-06-08,NE,15634,105773,121407,31,Nebraska
2020-06-08,NH,5043,80509,85552,33,New Hampshire
2020-06-08,NJ,164497,810592,975089,34,New Jersey
2020-06-08,NM,8940,225435,234375,35,New Mexico
2020-06-08,NV,9786,170217,180003,32,Nevada
2020-06-08,NY,378799,2177097,2555896,36,New York
2020-06-08,OH,38837,437981,476818,39,Ohio
2020-06-08,OK,7205,214598,221803,40,Oklahoma
2020-06-08,OR,4922,144957,149879,41,Oregon
2020-06-08,PA,76563,451387,527950,42,Pennsylvania
2020-06-08,PR,5046,NA,5046,72,Puerto Rico
2020-06-08,RI,15642,163527,179169,44,Rhode Island
2020-06-08,SC,14800,229861,244661,45,South Carolina
2020-06-08,SD,5471,52348,57819,46,South Dakota
2020-06-08,TN,26944,485819,512763,47,Tennessee
2020-06-08,TX,75616,1044700,1120316,48,Texas
2020-06-08,UT,12322,230577,242899,49,Utah
2020-06-08,VA,51251,332341,383592,51,Virginia
2020-06-08,VI,71,2128,2199,78,U.S. Virgin Islands
2020-06-08,VT,1075,41723,42798,50,Vermont
2020-06-08,WA,23729,381327,405056,53,Washington
2020-06-08,WI,21038,333253,354291,55,Wisconsin
2020-06-08,WV,2153,111452,113605,54,West Virginia
2020-06-08,WY,960,29014,29974,56,Wyoming
2020-06-07,AK,544,64360,64904,02,Alaska
2020-06-07,AL,20500,239066,259566,01,Alabama
2020-06-07,AR,9426,150847,160273,05,Arkansas
2020-06-07,AS,0,174,174,60,American Samoa
2020-06-07,AZ,26889,254732,281621,04,Arizona
2020-06-07,CA,128812,2233406,2362218,06,California
2020-06-07,CO,27848,185166,213014,08,Colorado
2020-06-07,CT,43968,258386,302354,09,Connecticut
2020-06-07,DC,9332,45215,54547,11,District of Columbia
2020-06-07,DE,9942,59055,68997,10,Delaware
2020-06-07,FL,63938,1152220,1216158,12,Florida
2020-06-07,GA,51898,487986,539884,13,Georgia
2020-06-07,GU,179,7284,7463,66,Guam
2020-06-07,HI,673,53382,54055,15,Hawaii
2020-06-07,IA,21667,166525,188192,19,Iowa
2020-06-07,ID,3139,52902,56041,16,Idaho
2020-06-07,IL,127757,915017,1042774,17,Illinois
2020-06-07,IN,37397,266866,304263,18,Indiana
2020-06-07,KS,10393,103260,113653,20,Kansas
2020-06-07,KY,11287,237775,249062,21,Kentucky
2020-06-07,LA,42816,391249,434065,22,Louisiana
2020-06-07,MA,103436,549054,652490,25,Massachusetts
2020-06-07,MD,57973,306830,364803,24,Maryland
2020-06-07,ME,2570,56399,58969,23,Maine
2020-06-07,MI,64969,661256,726225,26,Michigan
2020-06-07,MN,28988,324153,353141,27,Minnesota
2020-06-07,MO,14553,222305,236858,29,Missouri
2020-06-07,MP,27,7214,7241,69,Northern Mariana Islands
2020-06-07,MS,17270,185979,203249,28,Mississippi
2020-06-07,MT,545,46833,47378,30,Montana
2020-06-07,NC,35546,475680,511226,37,North Carolina
2020-06-07,ND,2861,77072,79933,38,North Dakota
2020-06-07,NE,15543,104226,119769,31,Nebraska
2020-06-07,NH,5019,78990,84009,33,New Hampshire
2020-06-07,NJ,164164,796261,960425,34,New Jersey
2020-06-07,NM,8800,220347,229147,35,New Mexico
2020-06-07,NV,9649,166048,175697,32,Nevada
2020-06-07,NY,378097,2119745,2497842,36,New York
2020-06-07,OH,38476,430548,469024,39,Ohio
2020-06-07,OK,7150,214598,221748,40,Oklahoma
2020-06-07,OR,4808,143592,148400,41,Oregon
2020-06-07,PA,76212,444173,520385,42,Pennsylvania
2020-06-07,PR,4985,NA,4985,72,Puerto Rico
2020-06-07,RI,15441,155298,170739,44,Rhode Island
2020-06-07,SC,14286,223573,237859,45,South Carolina
2020-06-07,SD,5438,51622,57060,46,South Dakota
2020-06-07,TN,26381,472387,498768,47,Tennessee
2020-06-07,TX,74978,1025468,1100446,48,Texas
2020-06-07,UT,12066,225885,237951,49,Utah
2020-06-07,VA,50681,329135,379816,51,Virginia
2020-06-07,VI,71,2125,2196,78,U.S. Virgin Islands
2020-06-07,VT,1063,40155,41218,50,Vermont
2020-06-07,WA,23442,377146,400588,53,Washington
2020-06-07,WI,20835,325867,346702,55,Wisconsin
2020-06-07,WV,2144,109663,111807,54,West Virginia
2020-06-07,WY,947,27804,28751,56,Wyoming
2020-06-06,AK,536,63365,63901,02,Alaska
2020-06-06,AL,20043,225601,245644,01,Alabama
2020-06-06,AR,9101,147656,156757,05,Arkansas
2020-06-06,AS,0,174,174,60,American Samoa
2020-06-06,AZ,25451,246195,271646,04,Arizona
2020-06-06,CA,126016,2182284,2308300,06,California
2020-06-06,CO,27615,180662,208277,08,Colorado
2020-06-06,CT,43818,251731,295549,09,Connecticut
2020-06-06,DC,9269,44409,53678,11,District of Columbia
2020-06-06,DE,9845,57790,67635,10,Delaware
2020-06-06,FL,62758,1111427,1174185,12,Florida
2020-06-06,GA,51309,471548,522857,13,Georgia
2020-06-06,GU,179,7284,7463,66,Guam
2020-06-06,HI,664,52593,53257,15,Hawaii
2020-06-06,IA,21478,163236,184714,19,Iowa
2020-06-06,ID,3111,52128,55239,16,Idaho
2020-06-06,IL,126890,895184,1022074,17,Illinois
2020-06-06,IN,36997,260533,297530,18,Indiana
2020-06-06,KS,10393,103260,113653,20,Kansas
2020-06-06,KY,11287,237775,249062,21,Kentucky
2020-06-06,LA,42486,385583,428069,22,Louisiana
2020-06-06,MA,103132,541507,644639,25,Massachusetts
2020-06-06,MD,57482,299894,357376,24,Maryland
2020-06-06,ME,2524,56399,58923,23,Maine
2020-06-06,MI,64914,650942,715856,26,Michigan
2020-06-06,MN,28853,314744,343597,27,Minnesota
2020-06-06,MO,14442,215623,230065,29,Missouri
2020-06-06,MP,26,6669,6695,69,Northern Mariana Islands
2020-06-06,MS,16769,176354,193123,28,Mississippi
2020-06-06,MT,540,46214,46754,30,Montana
2020-06-06,NC,34625,462725,497350,37,North Carolina
2020-06-06,ND,2816,76064,78880,38,North Dakota
2020-06-06,NE,15379,102168,117547,31,Nebraska
2020-06-06,NH,5019,78990,84009,33,New Hampshire
2020-06-06,NJ,163893,755555,919448,34,New Jersey
2020-06-06,NM,8672,215968,224640,35,New Mexico
2020-06-06,NV,9460,162311,171771,32,Nevada
2020-06-06,NY,377316,2060091,2437407,36,New York
2020-06-06,OH,38111,420415,458526,39,Ohio
2020-06-06,OK,7003,214598,221601,40,Oklahoma
2020-06-06,OR,4662,141497,146159,41,Oregon
2020-06-06,PA,75706,435122,510828,42,Pennsylvania
2020-06-06,PR,4915,NA,4915,72,Puerto Rico
2020-06-06,RI,15441,155298,170739,44,Rhode Island
2020-06-06,SC,13453,217846,231299,45,South Carolina
2020-06-06,SD,5367,50091,55458,46,South Dakota
2020-06-06,TN,26071,465350,491421,47,Tennessee
2020-06-06,TX,73553,1019724,1093277,48,Texas
2020-06-06,UT,11798,223351,235149,49,Utah
2020-06-06,VA,49397,321734,371131,51,Virginia
2020-06-06,VI,71,2125,2196,78,U.S. Virgin Islands
2020-06-06,VT,1046,39037,40083,50,Vermont
2020-06-06,WA,23169,377348,400517,53,Washington
2020-06-06,WI,20571,314802,335373,55,Wisconsin
2020-06-06,WV,2131,107592,109723,54,West Virginia
2020-06-06,WY,939,27569,28508,56,Wyoming
2020-06-05,AK,524,60466,60990,02,Alaska
2020-06-05,AL,19387,220086,239473,01,Alabama
2020-06-05,AR,8651,138960,147611,05,Arkansas
2020-06-05,AS,0,174,174,60,American Samoa
2020-06-05,AZ,24332,239533,263865,04,Arizona
2020-06-05,CA,122901,2115562,2238463,06,California
2020-06-05,CO,27360,176064,203424,08,Colorado
2020-06-05,CT,43460,243927,287387,09,Connecticut
2020-06-05,DC,9199,42662,51861,11,District of Columbia
2020-06-05,DE,9773,56956,66729,10,Delaware
2020-06-05,FL,61488,1073452,1134940,12,Florida
2020-06-05,GA,50621,457167,507788,13,Georgia
2020-06-05,GU,179,7195,7374,66,Guam
2020-06-05,HI,655,51681,52336,15,Hawaii
2020-06-05,IA,21152,159511,180663,19,Iowa
2020-06-05,ID,3054,50570,53624,16,Idaho
2020-06-05,IL,125915,875004,1000919,17,Illinois
2020-06-05,IN,36578,255060,291638,18,Indiana
2020-06-05,KS,10393,103260,113653,20,Kansas
2020-06-05,KY,10977,231440,242417,21,Kentucky
2020-06-05,LA,41989,378797,420786,22,Louisiana
2020-06-05,MA,102557,532212,634769,25,Massachusetts
2020-06-05,MD,56770,290956,347726,24,Maryland
2020-06-05,ME,2482,55050,57532,23,Maine
2020-06-05,MI,64821,640450,705271,26,Michigan
2020-06-05,MN,28688,304497,333185,27,Minnesota
2020-06-05,MO,14253,210289,224542,29,Missouri
2020-06-05,MP,26,6669,6695,69,Northern Mariana Islands
2020-06-05,MS,16759,176354,193113,28,Mississippi
2020-06-05,MT,541,45347,45888,30,Montana
2020-06-05,NC,33255,448892,482147,37,North Carolina
2020-06-05,ND,2745,74111,76856,38,North Dakota
2020-06-05,NE,15117,99705,114822,31,Nebraska
2020-06-05,NH,4876,74889,79765,33,New Hampshire
2020-06-05,NJ,163336,755555,918891,34,New Jersey
2020-06-05,NM,8353,209404,217757,35,New Mexico
2020-06-05,NV,9266,156841,166107,32,Nevada
2020-06-05,NY,376208,1983304,2359512,36,New York
2020-06-05,OH,37758,408437,446195,39,Ohio
2020-06-05,OK,6907,209564,216471,40,Oklahoma
2020-06-05,OR,4570,138676,143246,41,Oregon
2020-06-05,PA,75005,424201,499206,42,Pennsylvania
2020-06-05,PR,4620,NA,4620,72,Puerto Rico
2020-06-05,RI,15441,155298,170739,44,Rhode Island
2020-06-05,SC,13453,217846,231299,45,South Carolina
2020-06-05,SD,5277,48086,53363,46,South Dakota
2020-06-05,TN,25520,456652,482172,47,Tennessee
2020-06-05,TX,71613,989963,1061576,48,Texas
2020-06-05,UT,11252,220945,232197,49,Utah
2020-06-05,VA,48532,315238,363770,51,Virginia
2020-06-05,VI,71,1980,2051,78,U.S. Virgin Islands
2020-06-05,VT,1027,38090,39117,50,Vermont
2020-06-05,WA,23169,377348,400517,53,Washington
2020-06-05,WI,20249,303332,323581,55,Wisconsin
2020-06-05,WV,2119,106399,108518,54,West Virginia
2020-06-05,WY,933,26679,27612,56,Wyoming
2020-06-04,AK,513,59584,60097,02,Alaska
2020-06-04,AL,19072,216227,235299,01,Alabama
2020-06-04,AR,8067,134413,142480,05,Arkansas
2020-06-04,AS,0,174,174,60,American Samoa
2020-06-04,AZ,22753,227002,249755,04,Arizona
2020-06-04,CA,119807,2062864,2182671,06,California
2020-06-04,CO,27060,170140,197200,08,Colorado
2020-06-04,CT,43239,238286,281525,09,Connecticut
2020-06-04,DC,9120,41976,51096,11,District of Columbia
2020-06-04,DE,9746,56163,65909,10,Delaware
2020-06-04,FL,60183,1046860,1107043,12,Florida
2020-06-04,GA,49847,446484,496331,13,Georgia
2020-06-04,GU,179,6805,6984,66,Guam
2020-06-04,HI,653,49985,50638,15,Hawaii
2020-06-04,IA,20805,154130,174935,19,Iowa
2020-06-04,ID,2990,46815,49805,16,Idaho
2020-06-04,IL,124759,857257,982016,17,Illinois
2020-06-04,IN,36096,249138,285234,18,Indiana
2020-06-04,KS,10170,97883,108053,20,Kansas
2020-06-04,KY,10705,225220,235925,21,Kentucky
2020-06-04,LA,41562,369624,411186,22,Louisiana
2020-06-04,MA,102063,522872,624935,25,Massachusetts
2020-06-04,MD,55858,281160,337018,24,Maryland
2020-06-04,ME,2446,53755,56201,23,Maine
2020-06-04,MI,64616,627907,692523,26,Michigan
2020-06-04,MN,28290,293858,322148,27,Minnesota
2020-06-04,MO,14057,204604,218661,29,Missouri
2020-06-04,MP,26,6669,6695,69,Northern Mariana Islands
2020-06-04,MS,16560,168425,184985,28,Mississippi
2020-06-04,MT,539,44103,44642,30,Montana
2020-06-04,NC,31966,436336,468302,37,North Carolina
2020-06-04,ND,2706,73038,75744,38,North Dakota
2020-06-04,NE,14866,97389,112255,31,Nebraska
2020-06-04,NH,4795,71170,75965,33,New Hampshire
2020-06-04,NJ,162530,695199,857729,34,New Jersey
2020-06-04,NM,8140,204856,212996,35,New Mexico
2020-06-04,NV,9090,152333,161423,32,Nevada
2020-06-04,NY,375133,1917899,2293032,36,New York
2020-06-04,OH,37282,399969,437251,39,Ohio
2020-06-04,OK,6907,204815,211722,40,Oklahoma
2020-06-04,OR,4474,134838,139312,41,Oregon
2020-06-04,PA,74560,416942,491502,42,Pennsylvania
2020-06-04,PR,4508,NA,4508,72,Puerto Rico
2020-06-04,RI,15325,150598,165923,44,Rhode Island
2020-06-04,SC,13005,217846,230851,45,South Carolina
2020-06-04,SD,5247,47375,52622,46,South Dakota
2020-06-04,TN,25120,451018,476138,47,Tennessee
2020-06-04,TX,69920,968635,1038555,48,Texas
2020-06-04,UT,10813,216694,227507,49,Utah
2020-06-04,VA,47856,305734,353590,51,Virginia
2020-06-04,VI,71,1975,2046,78,U.S. Virgin Islands
2020-06-04,VT,1026,36808,37834,50,Vermont
2020-06-04,WA,23147,376335,399482,53,Washington
2020-06-04,WI,19892,291367,311259,55,Wisconsin
2020-06-04,WV,2092,103957,106049,54,West Virginia
2020-06-04,WY,915,26074,26989,56,Wyoming
2020-06-03,AK,505,57677,58182,02,Alaska
2020-06-03,AL,18851,212743,231594,01,Alabama
2020-06-03,AR,8067,134413,142480,05,Arkansas
2020-06-03,AS,0,174,174,60,American Samoa
2020-06-03,AZ,22233,222292,244525,04,Arizona
2020-06-03,CA,117687,2013607,2131294,06,California
2020-06-03,CO,26788,167389,194177,08,Colorado
2020-06-03,CT,43091,233345,276436,09,Connecticut
2020-06-03,DC,9016,40546,49562,11,District of Columbia
2020-06-03,DE,9712,55208,64920,10,Delaware
2020-06-03,FL,58764,1022149,1080913,12,Florida
2020-06-03,GA,48894,433818,482712,13,Georgia
2020-06-03,GU,178,6549,6727,66,Guam
2020-06-03,HI,653,48855,49508,15,Hawaii
2020-06-03,IA,20055,144390,164445,19,Iowa
2020-06-03,ID,2933,46009,48942,16,Idaho
2020-06-03,IL,123830,835345,959175,17,Illinois
2020-06-03,IN,35712,242103,277815,18,Indiana
2020-06-03,KS,10170,97883,108053,20,Kansas
2020-06-03,KY,10410,221789,232199,21,Kentucky
2020-06-03,LA,41133,360954,402087,22,Louisiana
2020-06-03,MA,101592,516169,617761,25,Massachusetts
2020-06-03,MD,54982,272643,327625,24,Maryland
2020-06-03,ME,2418,50591,53009,23,Maine
2020-06-03,MI,64382,613173,677555,26,Michigan
2020-06-03,MN,27889,283319,311208,27,Minnesota
2020-06-03,MO,13767,197586,211353,29,Missouri
2020-06-03,MP,23,6534,6557,69,Northern Mariana Islands
2020-06-03,MS,16322,168425,184747,28,Mississippi
2020-06-03,MT,525,42923,43448,30,Montana
2020-06-03,NC,30777,418486,449263,37,North Carolina
2020-06-03,ND,2679,71823,74502,38,North Dakota
2020-06-03,NE,14611,95355,109966,31,Nebraska
2020-06-03,NH,4749,70990,75739,33,New Hampshire
2020-06-03,NJ,162068,675352,837420,34,New Jersey
2020-06-03,NM,8024,198813,206837,35,New Mexico
2020-06-03,NV,8935,147320,156255,32,Nevada
2020-06-03,NY,374085,1855388,2229473,36,New York
2020-06-03,OH,36792,389313,426105,39,Ohio
2020-06-03,OK,6805,201247,208052,40,Oklahoma
2020-06-03,OR,4399,132269,136668,41,Oregon
2020-06-03,PA,74022,401369,475391,42,Pennsylvania
2020-06-03,PR,4023,NA,4023,72,Puerto Rico
2020-06-03,RI,15219,147321,162540,44,Rhode Island
2020-06-03,SC,12651,210274,222925,45,South Carolina
2020-06-03,SD,5162,43500,48662,46,South Dakota
2020-06-03,TN,24822,445957,470779,47,Tennessee
2020-06-03,TX,68271,938497,1006768,48,Texas
2020-06-03,UT,10497,213484,223981,49,Utah
2020-06-03,VA,46905,295482,342387,51,Virginia
2020-06-03,VI,70,1956,2026,78,U.S. Virgin Islands
2020-06-03,VT,990,36205,37195,50,Vermont
2020-06-03,WA,23077,373522,396599,53,Washington
2020-06-03,WI,19400,279711,299111,55,Wisconsin
2020-06-03,WV,2071,101697,103768,54,West Virginia
2020-06-03,WY,915,25713,26628,56,Wyoming
2020-06-02,AK,487,55716,56203,02,Alaska
2020-06-02,AL,18642,205160,223802,01,Alabama
2020-06-02,AR,7443,125793,133236,05,Arkansas
2020-06-02,AS,0,174,174,60,American Samoa
2020-06-02,AZ,21250,216583,237833,04,Arizona
2020-06-02,CA,115310,1956281,2071591,06,California
2020-06-02,CO,26577,163960,190537,08,Colorado
2020-06-02,CT,42979,227631,270610,09,Connecticut
2020-06-02,DC,8886,38815,47701,11,District of Columbia
2020-06-02,DE,9685,54377,64062,10,Delaware
2020-06-02,FL,57447,992305,1049752,12,Florida
2020-06-02,GA,48207,426080,474287,13,Georgia
2020-06-02,GU,177,6214,6391,66,Guam
2020-06-02,HI,652,48269,48921,15,Hawaii
2020-06-02,IA,20016,143674,163690,19,Iowa
2020-06-02,ID,2906,45227,48133,16,Idaho
2020-06-02,IL,122848,811856,934704,17,Illinois
2020-06-02,IN,35237,236682,271919,18,Indiana
2020-06-02,KS,10011,93301,103312,20,Kansas
2020-06-02,KY,10185,217086,227271,21,Kentucky
2020-06-02,LA,40746,352387,393133,22,Louisiana
2020-06-02,MA,101163,508232,609395,25,Massachusetts
2020-06-02,MD,54175,261640,315815,24,Maryland
2020-06-02,ME,2377,50591,52968,23,Maine
2020-06-02,MI,64103,597072,661175,26,Michigan
2020-06-02,MN,27376,267931,295307,27,Minnesota
2020-06-02,MO,13575,191855,205430,29,Missouri
2020-06-02,MP,23,6534,6557,69,Northern Mariana Islands
2020-06-02,MS,16020,163478,179498,28,Mississippi
2020-06-02,MT,523,41689,42212,30,Montana
2020-06-02,NC,29889,405032,434921,37,North Carolina
2020-06-02,ND,2646,70998,73644,38,North Dakota
2020-06-02,NE,14345,92073,106418,31,Nebraska
2020-06-02,NH,4685,69659,74344,33,New Hampshire
2020-06-02,NJ,161545,656132,817677,34,New Jersey
2020-06-02,NM,7800,195315,203115,35,New Mexico
2020-06-02,NV,8830,143261,152091,32,Nevada
2020-06-02,NY,373040,1794791,2167831,36,New York
2020-06-02,OH,36350,373558,409908,39,Ohio
2020-06-02,OK,6692,197965,204657,40,Oklahoma
2020-06-02,OR,4335,129874,134209,41,Oregon
2020-06-02,PA,73510,399361,472871,42,Pennsylvania
2020-06-02,PR,3935,NA,3935,72,Puerto Rico
2020-06-02,RI,15112,144448,159560,44,Rhode Island
2020-06-02,SC,12415,206362,218777,45,South Carolina
2020-06-02,SD,5067,41779,46846,46,South Dakota
2020-06-02,TN,24375,437761,462136,47,Tennessee
2020-06-02,TX,66568,919656,986224,48,Texas
2020-06-02,UT,10202,211589,221791,49,Utah
2020-06-02,VA,46239,282650,328889,51,Virginia
2020-06-02,VI,70,1936,2006,78,U.S. Virgin Islands
2020-06-02,VT,988,35631,36619,50,Vermont
2020-06-02,WA,22880,368513,391393,53,Washington
2020-06-02,WI,18917,263743,282660,55,Wisconsin
2020-06-02,WV,2041,98502,100543,54,West Virginia
2020-06-02,WY,910,24832,25742,56,Wyoming
2020-06-01,AK,467,53723,54190,02,Alaska
2020-06-01,AL,18363,205160,223523,01,Alabama
2020-06-01,AR,7443,125793,133236,05,Arkansas
2020-06-01,AS,0,174,174,60,American Samoa
2020-06-01,AZ,20123,207947,228070,04,Arizona
2020-06-01,CA,113006,1899577,2012583,06,California
2020-06-01,CO,26378,159998,186376,08,Colorado
2020-06-01,CT,42740,218650,261390,09,Connecticut
2020-06-01,DC,8857,38406,47263,11,District of Columbia
2020-06-01,DE,9605,52842,62447,10,Delaware
2020-06-01,FL,56830,983570,1040400,12,Florida
2020-06-01,GA,47618,424013,471631,13,Georgia
2020-06-01,GU,175,6141,6316,66,Guam
2020-06-01,HI,652,47835,48487,15,Hawaii
2020-06-01,IA,19697,139384,159081,19,Iowa
2020-06-01,ID,2839,43858,46697,16,Idaho
2020-06-01,IL,121234,797039,918273,17,Illinois
2020-06-01,IN,34830,231066,265896,18,Indiana
2020-06-01,KS,10011,85230,95241,20,Kansas
2020-06-01,KY,10046,206000,216046,21,Kentucky
2020-06-01,LA,40341,347029,387370,22,Louisiana
2020-06-01,MA,96965,495888,592853,25,Massachusetts
2020-06-01,MD,53327,255403,308730,24,Maryland
2020-06-01,ME,2349,47284,49633,23,Maine
2020-06-01,MI,63813,581424,645237,26,Michigan
2020-06-01,MN,26897,260739,287636,27,Minnesota
2020-06-01,MO,13327,186381,199708,29,Missouri
2020-06-01,MP,22,6312,6334,69,Northern Mariana Islands
2020-06-01,MS,15752,160502,176254,28,Mississippi
2020-06-01,MT,519,40138,40657,30,Montana
2020-06-01,NC,29263,392645,421908,37,North Carolina
2020-06-01,ND,2625,70676,73301,38,North Dakota
2020-06-01,NE,14101,89564,103665,31,Nebraska
2020-06-01,NH,4651,67805,72456,33,New Hampshire
2020-06-01,NJ,160918,634682,795600,34,New Jersey
2020-06-01,NM,7689,191915,199604,35,New Mexico
2020-06-01,NV,8688,138095,146783,32,Nevada
2020-06-01,NY,371711,1742066,2113777,36,New York
2020-06-01,OH,35984,362082,398066,39,Ohio
2020-06-01,OK,6573,186700,193273,40,Oklahoma
2020-06-01,OR,4302,127316,131618,41,Oregon
2020-06-01,PA,72898,389431,462329,42,Pennsylvania
2020-06-01,PR,3873,NA,3873,72,Puerto Rico
2020-06-01,RI,14991,141844,156835,44,Rhode Island
2020-06-01,SC,12148,192540,204688,45,South Carolina
2020-06-01,SD,5034,40627,45661,46,South Dakota
2020-06-01,TN,23554,424939,448493,47,Tennessee
2020-06-01,TX,64880,905151,970031,48,Texas
2020-06-01,UT,9999,208113,218112,49,Utah
2020-06-01,VA,45398,279321,324719,51,Virginia
2020-06-01,VI,70,1741,1811,78,U.S. Virgin Islands
2020-06-01,VT,983,34343,35326,50,Vermont
2020-06-01,WA,22603,361749,384352,53,Washington
2020-06-01,WI,18543,253595,272138,55,Wisconsin
2020-06-01,WV,2017,96078,98095,54,West Virginia
2020-06-01,WY,910,24237,25147,56,Wyoming
2020-05-31,AK,434,51261,51695,02,Alaska
2020-05-31,AL,17903,199650,217553,01,Alabama
2020-05-31,AR,7253,122262,129515,05,Arkansas
2020-05-31,AS,0,174,174,60,American Samoa
2020-05-31,AZ,19936,205270,225206,04,Arizona
2020-05-31,CA,110583,1834265,1944848,06,California
2020-05-31,CO,26098,154529,180627,08,Colorado
2020-05-31,CT,42201,207845,250046,09,Connecticut
2020-05-31,DC,8801,37682,46483,11,District of Columbia
2020-05-31,DE,9498,51173,60671,10,Delaware
2020-05-31,FL,56163,965186,1021349,12,Florida
2020-05-31,GA,46986,418539,465525,13,Georgia
2020-05-31,GU,173,5929,6102,66,Guam
2020-05-31,HI,651,53969,54620,15,Hawaii
2020-05-31,IA,19552,136744,156296,19,Iowa
2020-05-31,ID,2839,43858,46697,16,Idaho
2020-05-31,IL,120260,777999,898259,17,Illinois
2020-05-31,IN,34574,226972,261546,18,Indiana
2020-05-31,KS,9719,85230,94949,20,Kansas
2020-05-31,KY,9704,204049,213753,21,Kentucky
2020-05-31,LA,39916,335193,375109,22,Louisiana
2020-05-31,MA,96965,495888,592853,25,Massachusetts
2020-05-31,MD,52778,249103,301881,24,Maryland
2020-05-31,ME,2325,47284,49609,23,Maine
2020-05-31,MI,63568,567192,630760,26,Michigan
2020-05-31,MN,26322,257133,283455,27,Minnesota
2020-05-31,MO,13147,180414,193561,29,Missouri
2020-05-31,MP,22,6151,6173,69,Northern Mariana Islands
2020-05-31,MS,15501,156336,171837,28,Mississippi
2020-05-31,MT,515,39283,39798,30,Montana
2020-05-31,NC,28589,387700,416289,37,North Carolina
2020-05-31,ND,2577,69463,72040,38,North Dakota
2020-05-31,NE,13905,87237,101142,31,Nebraska
2020-05-31,NH,4545,65735,70280,33,New Hampshire
2020-05-31,NJ,160445,585700,746145,34,New Jersey
2020-05-31,NM,7624,186823,194447,35,New Mexico
2020-05-31,NV,8593,133967,142560,32,Nevada
2020-05-31,NY,370770,1693055,2063825,36,New York
2020-05-31,OH,35513,355395,390908,39,Ohio
2020-05-31,OK,6506,186700,193206,40,Oklahoma
2020-05-31,OR,4243,124958,129201,41,Oregon
2020-05-31,PA,72546,383111,455657,42,Pennsylvania
2020-05-31,PR,3776,NA,3776,72,Puerto Rico
2020-05-31,RI,14928,139565,154493,44,Rhode Island
2020-05-31,SC,11861,188355,200216,45,South Carolina
2020-05-31,SD,4993,39135,44128,46,South Dakota
2020-05-31,TN,23006,412971,435977,47,Tennessee
2020-05-31,TX,64287,887578,951865,48,Texas
2020-05-31,UT,9797,204117,213914,49,Utah
2020-05-31,VA,44607,270784,315391,51,Virginia
2020-05-31,VI,69,1633,1702,78,U.S. Virgin Islands
2020-05-31,VT,981,32989,33970,50,Vermont
2020-05-31,WA,22357,355080,377437,53,Washington
2020-05-31,WI,18403,250103,268506,55,Wisconsin
2020-05-31,WV,2010,95612,97622,54,West Virginia
2020-05-31,WY,903,23490,24393,56,Wyoming
2020-05-30,AK,434,51261,51695,02,Alaska
2020-05-30,AL,17359,194842,212201,01,Alabama
2020-05-30,AR,7013,119484,126497,05,Arkansas
2020-05-30,AS,0,174,174,60,American Samoa
2020-05-30,AZ,19255,197792,217047,04,Arizona
2020-05-30,CA,106878,1781717,1888595,06,California
2020-05-30,CO,25613,150128,175741,08,Colorado
2020-05-30,CT,42022,204913,246935,09,Connecticut
2020-05-30,DC,8717,36912,45629,11,District of Columbia
2020-05-30,DE,9422,49907,59329,10,Delaware
2020-05-30,FL,55424,939544,994968,12,Florida
2020-05-30,GA,46286,408552,454838,13,Georgia
2020-05-30,GU,173,5929,6102,66,Guam
2020-05-30,HI,649,53365,54014,15,Hawaii
2020-05-30,IA,19244,131179,150423,19,Iowa
2020-05-30,ID,2803,42621,45424,16,Idaho
2020-05-30,IL,118917,758188,877105,17,Illinois
2020-05-30,IN,34211,222184,256395,18,Indiana
2020-05-30,KS,9719,85230,94949,20,Kansas
2020-05-30,KY,9464,198731,208195,21,Kentucky
2020-05-30,LA,39577,329242,368819,22,Louisiana
2020-05-30,MA,96301,486218,582519,25,Massachusetts
2020-05-30,MD,52015,241931,293946,24,Maryland
2020-05-30,ME,2282,47284,49566,23,Maine
2020-05-30,MI,63321,554509,617830,26,Michigan
2020-05-30,MN,26181,250392,276573,27,Minnesota
2020-05-30,MO,12962,172468,185430,29,Missouri
2020-05-30,MP,22,5986,6008,69,Northern Mariana Islands
2020-05-30,MS,15229,150703,165932,28,Mississippi
2020-05-30,MT,505,38779,39284,30,Montana
2020-05-30,NC,27673,376484,404157,37,North Carolina
2020-05-30,ND,2554,68427,70981,38,North Dakota
2020-05-30,NE,13654,85354,99008,31,Nebraska
2020-05-30,NH,4492,64468,68960,33,New Hampshire
2020-05-30,NJ,159608,585700,745308,34,New Jersey
2020-05-30,NM,7493,180768,188261,35,New Mexico
2020-05-30,NV,8495,130037,138532,32,Nevada
2020-05-30,NY,369660,1635721,2005381,36,New York
2020-05-30,OH,35034,346913,381947,39,Ohio
2020-05-30,OK,6418,186700,193118,40,Oklahoma
2020-05-30,OR,4185,122610,126795,41,Oregon
2020-05-30,PA,72031,375741,447772,42,Pennsylvania
2020-05-30,PR,3718,NA,3718,72,Puerto Rico
2020-05-30,RI,14819,135498,150317,44,Rhode Island
2020-05-30,SC,11394,178125,189519,45,South Carolina
2020-05-30,SD,4960,37978,42938,46,South Dakota
2020-05-30,TN,22566,404480,427046,47,Tennessee
2020-05-30,TX,62338,866179,928517,48,Texas
2020-05-30,UT,9533,200572,210105,49,Utah
2020-05-30,VA,43611,261901,305512,51,Virginia
2020-05-30,VI,69,1633,1702,78,U.S. Virgin Islands
2020-05-30,VT,977,31690,32667,50,Vermont
2020-05-30,WA,22273,352915,375188,53,Washington
2020-05-30,WI,18230,242908,261138,55,Wisconsin
2020-05-30,WV,1974,93916,95890,54,West Virginia
2020-05-30,WY,898,23185,24083,56,Wyoming
2020-05-29,AK,430,49009,49439,02,Alaska
2020-05-29,AL,16823,192060,208883,01,Alabama
2020-05-29,AR,6538,113230,119768,05,Arkansas
2020-05-29,AS,0,174,174,60,American Samoa
2020-05-29,AZ,18465,191348,209813,04,Arizona
2020-05-29,CA,103886,1731592,1835478,06,California
2020-05-29,CO,25121,143838,168959,08,Colorado
2020-05-29,CT,41762,199631,241393,09,Connecticut
2020-05-29,DC,8538,35320,43858,11,District of Columbia
2020-05-29,DE,9236,48297,57533,10,Delaware
2020-05-29,FL,54497,928742,983239,12,Florida
2020-05-29,GA,45670,404601,450271,13,Georgia
2020-05-29,GU,172,5923,6095,66,Guam
2020-05-29,HI,647,52177,52824,15,Hawaii
2020-05-29,IA,18926,128394,147320,19,Iowa
2020-05-29,ID,2769,41992,44761,16,Idaho
2020-05-29,IL,117455,734307,851762,17,Illinois
2020-05-29,IN,33558,215155,248713,18,Indiana
2020-05-29,KS,9719,85230,94949,20,Kansas
2020-05-29,KY,9184,212090,221274,21,Kentucky
2020-05-29,LA,38802,316225,355027,22,Louisiana
2020-05-29,MA,95512,476233,571745,25,Massachusetts
2020-05-29,MD,50988,233530,284518,24,Maryland
2020-05-29,ME,2226,43480,45706,23,Maine
2020-05-29,MI,63116,538868,601984,26,Michigan
2020-05-29,MN,26013,242124,268137,27,Minnesota
2020-05-29,MO,12795,165055,177850,29,Missouri
2020-05-29,MP,22,5662,5684,69,Northern Mariana Islands
2020-05-29,MS,14790,151518,166308,28,Mississippi
2020-05-29,MT,493,38036,38529,30,Montana
2020-05-29,NC,26488,364743,391231,37,North Carolina
2020-05-29,ND,2520,66933,69453,38,North Dakota
2020-05-29,NE,13261,81542,94803,31,Nebraska
2020-05-29,NH,4386,62476,66862,33,New Hampshire
2020-05-29,NJ,158844,557567,716411,34,New Jersey
2020-05-29,NM,7364,176180,183544,35,New Mexico
2020-05-29,NV,8350,126066,134416,32,Nevada
2020-05-29,NY,368284,1575846,1944130,36,New York
2020-05-29,OH,34566,335324,369890,39,Ohio
2020-05-29,OK,6338,181060,187398,40,Oklahoma
2020-05-29,OR,4131,118550,122681,41,Oregon
2020-05-29,PA,71339,366970,438309,42,Pennsylvania
2020-05-29,PR,3647,NA,3647,72,Puerto Rico
2020-05-29,RI,14635,131720,146355,44,Rhode Island
2020-05-29,SC,11131,177126,188257,45,South Carolina
2020-05-29,SD,4866,35816,40682,46,South Dakota
2020-05-29,TN,22085,399882,421967,47,Tennessee
2020-05-29,TX,61006,832269,893275,48,Texas
2020-05-29,UT,9264,196591,205855,49,Utah
2020-05-29,VA,42533,255844,298377,51,Virginia
2020-05-29,VI,69,1633,1702,78,U.S. Virgin Islands
2020-05-29,VT,975,30910,31885,50,Vermont
2020-05-29,WA,22159,349690,371849,53,Washington
2020-05-29,WI,17707,233588,251295,55,Wisconsin
2020-05-29,WV,1951,91426,93377,54,West Virginia
2020-05-29,WY,891,22378,23269,56,Wyoming
2020-05-28,AK,425,47545,47970,02,Alaska
2020-05-28,AL,16310,184171,200481,01,Alabama
2020-05-28,AR,6538,112364,118902,05,Arkansas
2020-05-28,AS,0,174,174,60,American Samoa
2020-05-28,AZ,17763,185151,202914,04,Arizona
2020-05-28,CA,101697,1688862,1790559,06,California
2020-05-28,CO,24767,138356,163123,08,Colorado
2020-05-28,CT,41559,193966,235525,09,Connecticut
2020-05-28,DC,8492,35022,43514,11,District of Columbia
2020-05-28,DE,9171,47630,56801,10,Delaware
2020-05-28,FL,53285,898331,951616,12,Florida
2020-05-28,GA,45070,399576,444646,13,Georgia
2020-05-28,GU,172,5790,5962,66,Guam
2020-05-28,HI,644,51195,51839,15,Hawaii
2020-05-28,IA,18573,124360,142933,19,Iowa
2020-05-28,ID,2731,41144,43875,16,Idaho
2020-05-28,IL,115833,714133,829966,17,Illinois
2020-05-28,IN,33068,209219,242287,18,Indiana
2020-05-28,KS,9337,75151,84488,20,Kansas
2020-05-28,KY,9077,173024,182101,21,Kentucky
2020-05-28,LA,38802,316225,355027,22,Louisiana
2020-05-28,MA,94895,467428,562323,25,Massachusetts
2020-05-28,MD,49709,225149,274858,24,Maryland
2020-05-28,ME,2189,43480,45669,23,Maine
2020-05-28,MI,62797,522663,585460,26,Michigan
2020-05-28,MN,25559,232195,257754,27,Minnesota
2020-05-28,MO,12673,158394,171067,29,Missouri
2020-05-28,MP,22,5401,5423,69,Northern Mariana Islands
2020-05-28,MS,14372,142125,156497,28,Mississippi
2020-05-28,MT,485,36308,36793,30,Montana
2020-05-28,NC,25412,349780,375192,37,North Carolina
2020-05-28,ND,2481,65773,68254,38,North Dakota
2020-05-28,NE,12976,80004,92980,31,Nebraska
2020-05-28,NH,4286,61310,65596,33,New Hampshire
2020-05-28,NJ,157815,528042,685857,34,New Jersey
2020-05-28,NM,7252,172291,179543,35,New Mexico
2020-05-28,NV,8208,122982,131190,32,Nevada
2020-05-28,NY,366733,1510056,1876789,36,New York
2020-05-28,OH,33915,326097,360012,39,Ohio
2020-05-28,OK,6270,176136,182406,40,Oklahoma
2020-05-28,OR,4086,115561,119647,41,Oregon
2020-05-28,PA,70042,357804,427846,42,Pennsylvania
2020-05-28,PR,3486,NA,3486,72,Puerto Rico
2020-05-28,RI,14494,125871,140365,44,Rhode Island
2020-05-28,SC,10788,171461,182249,45,South Carolina
2020-05-28,SD,4793,34233,39026,46,South Dakota
2020-05-28,TN,21679,394310,415989,47,Tennessee
2020-05-28,TX,59776,813442,873218,48,Texas
2020-05-28,UT,8921,194586,203507,49,Utah
2020-05-28,VA,41401,245880,287281,51,Virginia
2020-05-28,VI,69,1617,1686,78,U.S. Virgin Islands
2020-05-28,VT,974,30178,31152,50,Vermont
2020-05-28,WA,21952,343612,365564,53,Washington
2020-05-28,WI,16974,220719,237693,55,Wisconsin
2020-05-28,WV,1906,88409,90315,54,West Virginia
2020-05-28,WY,874,22286,23160,56,Wyoming
2020-05-27,AK,412,45951,46363,02,Alaska
2020-05-27,AL,15843,179951,195794,01,Alabama
2020-05-27,AR,6277,109319,115596,05,Arkansas
2020-05-27,AS,0,174,174,60,American Samoa
2020-05-27,AZ,17262,179004,196266,04,Arizona
2020-05-27,CA,98980,1637914,1736894,06,California
2020-05-27,CO,24565,134855,159420,08,Colorado
2020-05-27,CT,41303,184059,225362,09,Connecticut
2020-05-27,DC,8406,34291,42697,11,District of Columbia
2020-05-27,DE,9096,46325,55421,10,Delaware
2020-05-27,FL,52634,880937,933571,12,Florida
2020-05-27,GA,44421,396335,440756,13,Georgia
2020-05-27,GU,170,5515,5685,66,Guam
2020-05-27,HI,643,50559,51202,15,Hawaii
2020-05-27,IA,18360,121166,139526,19,Iowa
2020-05-27,ID,2699,40318,43017,16,Idaho
2020-05-27,IL,114306,689667,803973,17,Illinois
2020-05-27,IN,32437,202896,235333,18,Indiana
2020-05-27,KS,9337,75151,84488,20,Kansas
2020-05-27,KY,9077,173024,182101,21,Kentucky
2020-05-27,LA,38497,309150,347647,22,Louisiana
2020-05-27,MA,94220,457924,552144,25,Massachusetts
2020-05-27,MD,48423,213632,262055,24,Maryland
2020-05-27,ME,2137,43480,45617,23,Maine
2020-05-27,MI,62461,505609,568070,26,Michigan
2020-05-27,MN,24988,222821,247809,27,Minnesota
2020-05-27,MO,12492,153029,165521,29,Missouri
2020-05-27,MP,22,5178,5200,69,Northern Mariana Islands
2020-05-27,MS,14044,134088,148132,28,Mississippi
2020-05-27,MT,481,35162,35643,30,Montana
2020-05-27,NC,24628,339528,364156,37,North Carolina
2020-05-27,ND,2439,64901,67340,38,North Dakota
2020-05-27,NE,12619,77802,90421,31,Nebraska
2020-05-27,NH,4231,60001,64232,33,New Hampshire
2020-05-27,NJ,156628,503697,660325,34,New Jersey
2020-05-27,NM,7130,173516,180646,35,New Mexico
2020-05-27,NV,8113,120446,128559,32,Nevada
2020-05-27,NY,364965,1446579,1811544,36,New York
2020-05-27,OH,33439,316286,349725,39,Ohio
2020-05-27,OK,6229,172409,178638,40,Oklahoma
2020-05-27,OR,4038,112954,116992,41,Oregon
2020-05-27,PA,69417,349990,419407,42,Pennsylvania
2020-05-27,PR,3397,NA,3397,72,Puerto Rico
2020-05-27,RI,14353,124030,138383,44,Rhode Island
2020-05-27,SC,10623,165060,175683,45,South Carolina
2020-05-27,SD,4710,33296,38006,46,South Dakota
2020-05-27,TN,21306,388324,409630,47,Tennessee
2020-05-27,TX,57921,797753,855674,48,Texas
2020-05-27,UT,8706,191920,200626,49,Utah
2020-05-27,VA,40249,236798,277047,51,Virginia
2020-05-27,VI,69,1442,1511,78,U.S. Virgin Islands
2020-05-27,VT,971,30028,30999,50,Vermont
2020-05-27,WA,21758,337545,359303,53,Washington
2020-05-27,WI,16462,210605,227067,55,Wisconsin
2020-05-27,WV,1867,86594,88461,54,West Virginia
2020-05-27,WY,850,20652,21502,56,Wyoming
2020-05-26,AK,411,44553,44964,02,Alaska
2020-05-26,AL,15396,178363,193759,01,Alabama
2020-05-26,AR,6180,105593,111773,05,Arkansas
2020-05-26,AS,0,124,124,60,American Samoa
2020-05-26,AZ,16783,173948,190731,04,Arizona
2020-05-26,CA,96733,1599663,1696396,06,California
2020-05-26,CO,24269,131742,156011,08,Colorado
2020-05-26,CT,41303,184059,225362,09,Connecticut
2020-05-26,DC,8334,33721,42055,11,District of Columbia
2020-05-26,DE,9066,45848,54914,10,Delaware
2020-05-26,FL,52255,870969,923224,12,Florida
2020-05-26,GA,43730,471215,514945,13,Georgia
2020-05-26,GU,169,5515,5684,66,Guam
2020-05-26,HI,643,49728,50371,15,Hawaii
2020-05-26,IA,17703,117301,135004,19,Iowa
2020-05-26,ID,2626,38780,41406,16,Idaho
2020-05-26,IL,113195,673599,786794,17,Illinois
2020-05-26,IN,32078,198671,230749,18,Indiana
2020-05-26,KS,9218,72181,81399,20,Kansas
2020-05-26,KY,8571,161285,169856,21,Kentucky
2020-05-26,LA,38054,302972,341026,22,Louisiana
2020-05-26,MA,93693,451788,545481,25,Massachusetts
2020-05-26,MD,47687,206800,254487,24,Maryland
2020-05-26,ME,2109,35450,37559,23,Maine
2020-05-26,MI,62075,487906,549981,26,Michigan
2020-05-26,MN,24308,213974,238282,27,Minnesota
2020-05-26,MO,12291,148007,160298,29,Missouri
2020-05-26,MP,22,4918,4940,69,Northern Mariana Islands
2020-05-26,MS,13731,134088,147819,28,Mississippi
2020-05-26,MT,479,33355,33834,30,Montana
2020-05-26,NC,24140,328191,352331,37,North Carolina
2020-05-26,ND,2422,64432,66854,38,North Dakota
2020-05-26,NE,12355,75687,88042,31,Nebraska
2020-05-26,NH,4197,58842,63039,33,New Hampshire
2020-05-26,NJ,155764,480128,635892,34,New Jersey
2020-05-26,NM,7026,170335,177361,35,New Mexico
2020-05-26,NV,7997,115370,123367,32,Nevada
2020-05-26,NY,363836,1410292,1774128,36,New York
2020-05-26,OH,33006,306394,339400,39,Ohio
2020-05-26,OK,6137,153804,159941,40,Oklahoma
2020-05-26,OR,3967,111571,115538,41,Oregon
2020-05-26,PA,68637,339835,408472,42,Pennsylvania
2020-05-26,PR,3324,NA,3324,72,Puerto Rico
2020-05-26,RI,14210,121153,135363,44,Rhode Island
2020-05-26,SC,10416,162318,172734,45,South Carolina
2020-05-26,SD,4653,32385,37038,46,South Dakota
2020-05-26,TN,20965,382539,403504,47,Tennessee
2020-05-26,TX,56560,764673,821233,48,Texas
2020-05-26,UT,8620,189972,198592,49,Utah
2020-05-26,VA,39342,227839,267181,51,Virginia
2020-05-26,VI,69,1425,1494,78,U.S. Virgin Islands
2020-05-26,VT,967,29456,30423,50,Vermont
2020-05-26,WA,21522,331090,352612,53,Washington
2020-05-26,WI,15863,200874,216737,55,Wisconsin
2020-05-26,WV,1854,85957,87811,54,West Virginia
2020-05-26,WY,850,20652,21502,56,Wyoming
2020-05-25,AK,409,44063,44472,02,Alaska
2020-05-25,AL,14730,175585,190315,01,Alabama
2020-05-25,AR,6029,105593,111622,05,Arkansas
2020-05-25,AS,0,124,124,60,American Samoa
2020-05-25,AZ,16561,171221,187782,04,Arizona
2020-05-25,CA,94558,1549544,1644102,06,California
2020-05-25,CO,24174,126134,150308,08,Colorado
2020-05-25,CT,40873,180853,221726,09,Connecticut
2020-05-25,DC,8225,32578,40803,11,District of Columbia
2020-05-25,DE,8965,44931,53896,10,Delaware
2020-05-25,FL,51746,856489,908235,12,Florida
2020-05-25,GA,43344,470201,513545,13,Georgia
2020-05-25,GU,166,5403,5569,66,Guam
2020-05-25,HI,643,49728,50371,15,Hawaii
2020-05-25,IA,17577,115138,132715,19,Iowa
2020-05-25,ID,2626,38780,41406,16,Idaho
2020-05-25,IL,112017,657547,769564,17,Illinois
2020-05-25,IN,31715,194536,226251,18,Indiana
2020-05-25,KS,9218,72181,81399,20,Kansas
2020-05-25,KY,8571,161285,169856,21,Kentucky
2020-05-25,LA,37809,293089,330898,22,Louisiana
2020-05-25,MA,93271,447290,540561,25,Massachusetts
2020-05-25,MD,47152,202425,249577,24,Maryland
2020-05-25,ME,2074,35450,37524,23,Maine
2020-05-25,MI,61632,476325,537957,26,Michigan
2020-05-25,MN,23524,207816,231340,27,Minnesota
2020-05-25,MO,12167,145218,157385,29,Missouri
2020-05-25,MP,22,4735,4757,69,Northern Mariana Islands
2020-05-25,MS,13458,130459,143917,28,Mississippi
2020-05-25,MT,479,33203,33682,30,Montana
2020-05-25,NC,23964,320726,344690,37,North Carolina
2020-05-25,ND,2457,63893,66350,38,North Dakota
2020-05-25,NE,12134,73598,85732,31,Nebraska
2020-05-25,NH,4149,57237,61386,33,New Hampshire
2020-05-25,NJ,155092,468705,623797,34,New Jersey
2020-05-25,NM,6943,166538,173481,35,New Mexico
2020-05-25,NV,7879,106852,114731,32,Nevada
2020-05-25,NY,362764,1376685,1739449,36,New York
2020-05-25,OH,32477,297857,330334,39,Ohio
2020-05-25,OK,6090,154943,161033,40,Oklahoma
2020-05-25,OR,3949,109909,113858,41,Oregon
2020-05-25,PA,68186,334928,403114,42,Pennsylvania
2020-05-25,PR,3260,NA,3260,72,Puerto Rico
2020-05-25,RI,14065,118636,132701,44,Rhode Island
2020-05-25,SC,10178,155842,166020,45,South Carolina
2020-05-25,SD,4586,30697,35283,46,South Dakota
2020-05-25,TN,20607,375612,396219,47,Tennessee
2020-05-25,TX,55971,749683,805654,48,Texas
2020-05-25,UT,8521,187947,196468,49,Utah
2020-05-25,VA,37727,221023,258750,51,Virginia
2020-05-25,VI,69,1343,1412,78,U.S. Virgin Islands
2020-05-25,VT,962,28707,29669,50,Vermont
2020-05-25,WA,21279,323483,344762,53,Washington
2020-05-25,WI,15584,193379,208963,55,Wisconsin
2020-05-25,WV,1774,84551,86325,54,West Virginia
2020-05-25,WY,838,19551,20389,56,Wyoming
2020-05-24,AK,408,43099,43507,02,Alaska
2020-05-24,AL,14327,171472,185799,01,Alabama
2020-05-24,AR,5922,102659,108581,05,Arkansas
2020-05-24,AS,0,124,124,60,American Samoa
2020-05-24,AZ,16339,167302,183641,04,Arizona
2020-05-24,CA,92710,1490035,1582745,06,California
2020-05-24,CO,23964,126087,150051,08,Colorado
2020-05-24,CT,40468,173668,214136,09,Connecticut
2020-05-24,DC,7966,44025,51991,11,District of Columbia
2020-05-24,DE,8809,43061,51870,10,Delaware
2020-05-24,FL,50867,820368,871235,12,Florida
2020-05-24,GA,42838,439116,481954,13,Georgia
2020-05-24,GU,166,5403,5569,66,Guam
2020-05-24,HI,643,48929,49572,15,Hawaii
2020-05-24,IA,17252,110504,127756,19,Iowa
2020-05-24,ID,2626,38780,41406,16,Idaho
2020-05-24,IL,110304,637617,747921,17,Illinois
2020-05-24,IN,31376,189425,220801,18,Indiana
2020-05-24,KS,8958,67476,76434,20,Kansas
2020-05-24,KY,8571,161285,169856,21,Kentucky
2020-05-24,LA,37169,278867,316036,22,Louisiana
2020-05-24,MA,92675,439698,532373,25,Massachusetts
2020-05-24,MD,46313,194049,240362,24,Maryland
2020-05-24,ME,2055,35450,37505,23,Maine
2020-05-24,MI,61457,467087,528544,26,Michigan
2020-05-24,MN,23121,201566,224687,27,Minnesota
2020-05-24,MO,11988,139631,151619,29,Missouri
2020-05-24,MP,22,4735,4757,69,Northern Mariana Islands
2020-05-24,MS,13252,124650,137902,28,Mississippi
2020-05-24,MT,479,32902,33381,30,Montana
2020-05-24,NC,23222,313434,336656,37,North Carolina
2020-05-24,ND,2418,63070,65488,38,North Dakota
2020-05-24,NE,11989,71216,83205,31,Nebraska
2020-05-24,NH,4089,55450,59539,33,New Hampshire
2020-05-24,NJ,154154,449653,603807,34,New Jersey
2020-05-24,NM,6795,162324,169119,35,New Mexico
2020-05-24,NV,7770,102511,110281,32,Nevada
2020-05-24,NY,361515,1338311,1699826,36,New York
2020-05-24,OH,31911,292642,324553,39,Ohio
2020-05-24,OK,6037,154943,160980,40,Oklahoma
2020-05-24,OR,3927,108268,112195,41,Oregon
2020-05-24,PA,67713,328382,396095,42,Pennsylvania
2020-05-24,PR,3189,NA,3189,72,Puerto Rico
2020-05-24,RI,14065,118636,132701,44,Rhode Island
2020-05-24,SC,10096,153851,163947,45,South Carolina
2020-05-24,SD,4563,30342,34905,46,South Dakota
2020-05-24,TN,20145,363431,383576,47,Tennessee
2020-05-24,TX,55348,708197,763545,48,Texas
2020-05-24,UT,8392,186041,194433,49,Utah
2020-05-24,VA,36244,207841,244085,51,Virginia
2020-05-24,VI,69,1343,1412,78,U.S. Virgin Islands
2020-05-24,VT,956,27634,28590,50,Vermont
2020-05-24,WA,21070,321298,342368,53,Washington
2020-05-24,WI,15277,186206,201483,55,Wisconsin
2020-05-24,WV,1759,83935,85694,54,West Virginia
2020-05-24,WY,813,19221,20034,56,Wyoming
2020-05-23,AK,408,41943,42351,02,Alaska
2020-05-23,AL,13938,168738,182676,01,Alabama
2020-05-23,AR,5612,97435,103047,05,Arkansas
2020-05-23,AS,0,124,124,60,American Samoa
2020-05-23,AZ,16039,164400,180439,04,Arizona
2020-05-23,CA,90631,1424675,1515306,06,California
2020-05-23,CO,23487,121465,144952,08,Colorado
2020-05-23,CT,40022,168345,208367,09,Connecticut
2020-05-23,DC,7966,44025,51991,11,District of Columbia
2020-05-23,DE,8690,41844,50534,10,Delaware
2020-05-23,FL,50127,806310,856437,12,Florida
2020-05-23,GA,42132,411405,453537,13,Georgia
2020-05-23,GU,165,5194,5359,66,Guam
2020-05-23,HI,642,48179,48821,15,Hawaii
2020-05-23,IA,16893,107048,123941,19,Iowa
2020-05-23,ID,2595,38014,40609,16,Idaho
2020-05-23,IL,107796,614451,722247,17,Illinois
2020-05-23,IN,30901,184032,214933,18,Indiana
2020-05-23,KS,8958,67476,76434,20,Kansas
2020-05-23,KY,8426,163033,171459,21,Kentucky
2020-05-23,LA,37040,277407,314447,22,Louisiana
2020-05-23,MA,91662,429324,520986,25,Massachusetts
2020-05-23,MD,45495,186832,232327,24,Maryland
2020-05-23,ME,2013,35450,37463,23,Maine
2020-05-23,MI,61293,455556,516849,26,Michigan
2020-05-23,MN,22765,194941,217706,27,Minnesota
2020-05-23,MO,11752,136552,148304,29,Missouri
2020-05-23,MP,22,4296,4318,69,Northern Mariana Islands
2020-05-23,MS,13005,121215,134220,28,Mississippi
2020-05-23,MT,479,32173,32652,30,Montana
2020-05-23,NC,22725,306857,329582,37,North Carolina
2020-05-23,ND,2365,61783,64148,38,North Dakota
2020-05-23,NE,11662,68320,79982,31,Nebraska
2020-05-23,NH,4089,55450,59539,33,New Hampshire
2020-05-23,NJ,153104,425631,578735,34,New Jersey
2020-05-23,NM,6625,151758,158383,35,New Mexico
2020-05-23,NV,7696,99351,107047,32,Nevada
2020-05-23,NY,359926,1292135,1652061,36,New York
2020-05-23,OH,31408,285086,316494,39,Ohio
2020-05-23,OK,5960,154943,160903,40,Oklahoma
2020-05-23,OR,3888,106319,110207,41,Oregon
2020-05-23,PA,66983,321469,388452,42,Pennsylvania
2020-05-23,PR,3100,NA,3100,72,Puerto Rico
2020-05-23,RI,13952,116180,130132,44,Rhode Island
2020-05-23,SC,9895,149015,158910,45,South Carolina
2020-05-23,SD,4468,29060,33528,46,South Dakota
2020-05-23,TN,19789,353969,373758,47,Tennessee
2020-05-23,TX,54509,708197,762706,48,Texas
2020-05-23,UT,8260,182519,190779,49,Utah
2020-05-23,VA,35749,196721,232470,51,Virginia
2020-05-23,VI,69,1343,1412,78,U.S. Virgin Islands
2020-05-23,VT,954,26470,27424,50,Vermont
2020-05-23,WA,20933,319173,340106,53,Washington
2020-05-23,WI,14877,179329,194206,55,Wisconsin
2020-05-23,WV,1717,82027,83744,54,West Virginia
2020-05-23,WY,813,19221,20034,56,Wyoming
2020-05-22,AK,404,41042,41446,02,Alaska
2020-05-22,AL,13563,164205,177768,01,Alabama
2020-05-22,AR,5612,97435,103047,05,Arkansas
2020-05-22,AS,0,124,124,60,American Samoa
2020-05-22,AZ,15608,160395,176003,04,Arizona
2020-05-22,CA,88444,1378329,1466773,06,California
2020-05-22,CO,23191,119034,142225,08,Colorado
2020-05-22,CT,39640,162688,202328,09,Connecticut
2020-05-22,DC,7893,35100,42993,11,District of Columbia
2020-05-22,DE,8529,40457,48986,10,Delaware
2020-05-22,FL,49451,786045,835496,12,Florida
2020-05-22,GA,41218,386031,427249,13,Georgia
2020-05-22,GU,165,5114,5279,66,Guam
2020-05-22,HI,647,47338,47985,15,Hawaii
2020-05-22,IA,16504,103746,120250,19,Iowa
2020-05-22,ID,2534,37061,39595,16,Idaho
2020-05-22,IL,105444,591689,697133,17,Illinois
2020-05-22,IN,30409,178152,208561,18,Indiana
2020-05-22,KS,8958,67476,76434,20,Kansas
2020-05-22,KY,8286,157954,166240,21,Kentucky
2020-05-22,LA,36925,274883,311808,22,Louisiana
2020-05-22,MA,90889,420755,511644,25,Massachusetts
2020-05-22,MD,44424,183478,227902,24,Maryland
2020-05-22,ME,1948,35450,37398,23,Maine
2020-05-22,MI,61075,441282,502357,26,Michigan
2020-05-22,MN,22374,186436,208810,27,Minnesota
2020-05-22,MO,11558,161388,172946,29,Missouri
2020-05-22,MP,22,4296,4318,69,Northern Mariana Islands
2020-05-22,MS,12624,125349,137973,28,Mississippi
2020-05-22,MT,479,31378,31857,30,Montana
2020-05-22,NC,21618,281606,303224,37,North Carolina
2020-05-22,ND,2317,60513,62830,38,North Dakota
2020-05-22,NE,11425,66994,78419,31,Nebraska
2020-05-22,NH,3935,51165,55100,33,New Hampshire
2020-05-22,NJ,152719,402595,555314,34,New Jersey
2020-05-22,NM,6472,146295,152767,35,New Mexico
2020-05-22,NV,7401,92540,99941,32,Nevada
2020-05-22,NY,358154,1242639,1600793,36,New York
2020-05-22,OH,30794,277006,307800,39,Ohio
2020-05-22,OK,5849,147318,153167,40,Oklahoma
2020-05-22,OR,3864,103975,107839,41,Oregon
2020-05-22,PA,66258,312743,379001,42,Pennsylvania
2020-05-22,PR,3030,NA,3030,72,Puerto Rico
2020-05-22,RI,13736,113403,127139,44,Rhode Island
2020-05-22,SC,9638,140385,150023,45,South Carolina
2020-05-22,SD,4356,27988,32344,46,South Dakota
2020-05-22,TN,19394,341622,361016,47,Tennessee
2020-05-22,TX,53449,687913,741362,48,Texas
2020-05-22,UT,8057,178777,186834,49,Utah
2020-05-22,VA,34950,190225,225175,51,Virginia
2020-05-22,VI,69,1343,1412,78,U.S. Virgin Islands
2020-05-22,VT,952,24781,25733,50,Vermont
2020-05-22,WA,20747,316628,337375,53,Washington
2020-05-22,WI,14396,172703,187099,55,Wisconsin
2020-05-22,WV,1616,83213,84829,54,West Virginia
2020-05-22,WY,803,18621,19424,56,Wyoming
2020-05-21,AK,402,39143,39545,02,Alaska
2020-05-21,AL,13119,157620,170739,01,Alabama
2020-05-21,AR,5458,93818,99276,05,Arkansas
2020-05-21,AS,0,124,124,60,American Samoa
2020-05-21,AZ,15315,156312,171627,04,Arizona
2020-05-21,CA,86197,1334930,1421127,06,California
2020-05-21,CO,22797,112814,135611,08,Colorado
2020-05-21,CT,39208,157239,196447,09,Connecticut
2020-05-21,DC,7788,33968,41756,11,District of Columbia
2020-05-21,DE,8386,39156,47542,10,Delaware
2020-05-21,FL,48675,765254,813929,12,Florida
2020-05-21,GA,40405,367326,407731,13,Georgia
2020-05-21,GU,165,4899,5064,66,Guam
2020-05-21,HI,643,46506,47149,15,Hawaii
2020-05-21,IA,16170,100395,116565,19,Iowa
2020-05-21,ID,2506,36382,38888,16,Idaho
2020-05-21,IL,102686,569334,672020,17,Illinois
2020-05-21,IN,29936,173059,202995,18,Indiana
2020-05-21,KS,8539,62664,71203,20,Kansas
2020-05-21,KY,8167,150505,158672,21,Kentucky
2020-05-21,LA,36504,268877,305381,22,Louisiana
2020-05-21,MA,90084,411402,501486,25,Massachusetts
2020-05-21,MD,43531,176702,220233,24,Maryland
2020-05-21,ME,1877,35450,37327,23,Maine
2020-05-21,MI,60610,421788,482398,26,Michigan
2020-05-21,MN,21582,177506,199088,27,Minnesota
2020-05-21,MO,11340,150752,162092,29,Missouri
2020-05-21,MP,22,4067,4089,69,Northern Mariana Islands
2020-05-21,MS,12222,113748,125970,28,Mississippi
2020-05-21,MT,479,30045,30524,30,Montana
2020-05-21,NC,20860,269785,290645,37,North Carolina
2020-05-21,ND,2229,59050,61279,38,North Dakota
2020-05-21,NE,11122,64518,75640,31,Nebraska
2020-05-21,NH,3868,48962,52830,33,New Hampshire
2020-05-21,NJ,151472,392802,544274,34,New Jersey
2020-05-21,NM,6317,141027,147344,35,New Mexico
2020-05-21,NV,7255,87127,94382,32,Nevada
2020-05-21,NY,356458,1198597,1555055,36,New York
2020-05-21,OH,30167,268911,299078,39,Ohio
2020-05-21,OK,5680,143915,149595,40,Oklahoma
2020-05-21,OR,3817,101407,105224,41,Oregon
2020-05-21,PA,65392,303514,368906,42,Pennsylvania
2020-05-21,PR,2913,NA,2913,72,Puerto Rico
2020-05-21,RI,13571,109796,123367,44,Rhode Island
2020-05-21,SC,9175,129063,138238,45,South Carolina
2020-05-21,SD,4250,27051,31301,46,South Dakota
2020-05-21,TN,18961,341622,360583,47,Tennessee
2020-05-21,TX,52268,687913,740181,48,Texas
2020-05-21,UT,7874,175000,182874,49,Utah
2020-05-21,VA,34137,184462,218599,51,Virginia
2020-05-21,VI,69,1314,1383,78,U.S. Virgin Islands
2020-05-21,VT,950,24751,25701,50,Vermont
2020-05-21,WA,20482,311241,331723,53,Washington
2020-05-21,WI,13885,163238,177123,55,Wisconsin
2020-05-21,WV,1593,81548,83141,54,West Virginia
2020-05-21,WY,787,18053,18840,56,Wyoming
2020-05-20,AK,402,36643,37045,02,Alaska
2020-05-20,AL,12744,151706,164450,01,Alabama
2020-05-20,AR,5003,91255,96258,05,Arkansas
2020-05-20,AS,0,124,124,60,American Samoa
2020-05-20,AZ,14897,150538,165435,04,Arizona
2020-05-20,CA,84057,1296063,1380120,06,California
2020-05-20,CO,22482,109355,131837,08,Colorado
2020-05-20,CT,39017,151701,190718,09,Connecticut
2020-05-20,DC,7551,32868,40419,11,District of Columbia
2020-05-20,DE,8194,37218,45412,10,Delaware
2020-05-20,FL,47471,723877,771348,12,Florida
2020-05-20,GA,39647,363293,402940,13,Georgia
2020-05-20,GU,165,4807,4972,66,Guam
2020-05-20,HI,641,45663,46304,15,Hawaii
2020-05-20,IA,15614,95134,110748,19,Iowa
2020-05-20,ID,2476,36091,38567,16,Idaho
2020-05-20,IL,100418,542295,642713,17,Illinois
2020-05-20,IN,29274,166464,195738,18,Indiana
2020-05-20,KS,8539,62664,71203,20,Kansas
2020-05-20,KY,8069,145917,153986,21,Kentucky
2020-05-20,LA,35316,250654,285970,22,Louisiana
2020-05-20,MA,88970,400983,489953,25,Massachusetts
2020-05-20,MD,42323,173007,215330,24,Maryland
2020-05-20,ME,1819,35450,37269,23,Maine
2020-05-20,MI,60151,405848,465999,26,Michigan
2020-05-20,MN,20609,170199,190808,27,Minnesota
2020-05-20,MO,11232,150752,161984,29,Missouri
2020-05-20,MP,21,3796,3817,69,Northern Mariana Islands
2020-05-20,MS,11967,108713,120680,28,Mississippi
2020-05-20,MT,478,29248,29726,30,Montana
2020-05-20,NC,20122,257481,277603,37,North Carolina
2020-05-20,ND,2095,57105,59200,38,North Dakota
2020-05-20,NE,10846,61289,72135,31,Nebraska
2020-05-20,NH,3721,47167,50888,33,New Hampshire
2020-05-20,NJ,150399,380944,531343,34,New Jersey
2020-05-20,NM,6192,136054,142246,35,New Mexico
2020-05-20,NV,7166,84005,91171,32,Nevada
2020-05-20,NY,354370,1151466,1505836,36,New York
2020-05-20,OH,29436,260092,289528,39,Ohio
2020-05-20,OK,5532,138839,144371,40,Oklahoma
2020-05-20,OR,3801,98348,102149,41,Oregon
2020-05-20,PA,63666,286034,349700,42,Pennsylvania
2020-05-20,PR,2866,NA,2866,72,Puerto Rico
2020-05-20,RI,13356,107172,120528,44,Rhode Island
2020-05-20,SC,9056,126007,135063,45,South Carolina
2020-05-20,SD,4177,26212,30389,46,South Dakota
2020-05-20,TN,18532,335481,354013,47,Tennessee
2020-05-20,TX,51323,669605,720928,48,Texas
2020-05-20,UT,7710,171954,179664,49,Utah
2020-05-20,VA,32908,179718,212626,51,Virginia
2020-05-20,VI,69,1314,1383,78,U.S. Virgin Islands
2020-05-20,VT,944,24114,25058,50,Vermont
2020-05-20,WA,20296,305629,325925,53,Washington
2020-05-20,WI,13413,154300,167713,55,Wisconsin
2020-05-20,WV,1545,79096,80641,54,West Virginia
2020-05-20,WY,787,18053,18840,56,Wyoming
2020-05-19,AK,399,35981,36380,02,Alaska
2020-05-19,AL,12376,145190,157566,01,Alabama
2020-05-19,AR,4923,88778,93701,05,Arkansas
2020-05-19,AS,0,124,124,60,American Samoa
2020-05-19,AZ,14566,147005,161571,04,Arizona
2020-05-19,CA,81795,1257521,1339316,06,California
2020-05-19,CO,22202,109131,131333,08,Colorado
2020-05-19,CT,38430,147090,185520,09,Connecticut
2020-05-19,DC,7434,31940,39374,11,District of Columbia
2020-05-19,DE,8037,36095,44132,10,Delaware
2020-05-19,FL,46944,668911,715855,12,Florida
2020-05-19,GA,38721,339435,378156,13,Georgia
2020-05-19,GU,154,4673,4827,66,Guam
2020-05-19,HI,640,44383,45023,15,Hawaii
2020-05-19,IA,15349,92299,107648,19,Iowa
2020-05-19,ID,2455,35614,38069,16,Idaho
2020-05-19,IL,98030,523654,621684,17,Illinois
2020-05-19,IN,28705,160625,189330,18,Indiana
2020-05-19,KS,8340,58650,66990,20,Kansas
2020-05-19,KY,8069,145917,153986,21,Kentucky
2020-05-19,LA,35038,243035,278073,22,Louisiana
2020-05-19,MA,87925,389015,476940,25,Massachusetts
2020-05-19,MD,41546,167112,208658,24,Maryland
2020-05-19,ME,1741,22092,23833,23,Maine
2020-05-19,MI,59576,392208,451784,26,Michigan
2020-05-19,MN,19842,164009,183851,27,Minnesota
2020-05-19,MO,11080,143030,154110,29,Missouri
2020-05-19,MP,21,3796,3817,69,Northern Mariana Islands
2020-05-19,MS,11704,106056,117760,28,Mississippi
2020-05-19,MT,471,28479,28950,30,Montana
2020-05-19,NC,19700,245308,265008,37,North Carolina
2020-05-19,ND,1994,55737,57731,38,North Dakota
2020-05-19,NE,10625,59359,69984,31,Nebraska
2020-05-19,NH,3652,45822,49474,33,New Hampshire
2020-05-19,NJ,149013,371169,520182,34,New Jersey
2020-05-19,NM,6096,131524,137620,35,New Mexico
2020-05-19,NV,7046,80509,87555,32,Nevada
2020-05-19,NY,352845,1114894,1467739,36,New York
2020-05-19,OH,28952,248650,277602,39,Ohio
2020-05-19,OK,5489,133658,139147,40,Oklahoma
2020-05-19,OR,3726,95994,99720,41,Oregon
2020-05-19,PA,63666,286034,349700,42,Pennsylvania
2020-05-19,PR,2805,NA,2805,72,Puerto Rico
2020-05-19,RI,12951,104295,117246,44,Rhode Island
2020-05-19,SC,9056,126007,135063,45,South Carolina
2020-05-19,SD,4085,25624,29709,46,South Dakota
2020-05-19,TN,18378,327745,346123,47,Tennessee
2020-05-19,TX,49912,650234,700146,48,Texas
2020-05-19,UT,7518,169793,177311,49,Utah
2020-05-19,VA,32145,170644,202789,51,Virginia
2020-05-19,VI,69,1298,1367,78,U.S. Virgin Islands
2020-05-19,VT,944,24114,25058,50,Vermont
2020-05-19,WA,20066,298603,318669,53,Washington
2020-05-19,WI,12885,148237,161122,55,Wisconsin
2020-05-19,WV,1509,76792,78301,54,West Virginia
2020-05-19,WY,766,17084,17850,56,Wyoming
2020-05-18,AK,399,35212,35611,02,Alaska
2020-05-18,AL,12086,145037,157123,01,Alabama
2020-05-18,AR,4813,80426,85239,05,Arkansas
2020-05-18,AS,0,105,105,60,American Samoa
2020-05-18,AZ,14170,142303,156473,04,Arizona
2020-05-18,CA,80430,1212242,1292672,06,California
2020-05-18,CO,21938,106557,128495,08,Colorado
2020-05-18,CT,38116,139563,177679,09,Connecticut
2020-05-18,DC,7270,30555,37825,11,District of Columbia
2020-05-18,DE,7869,34589,42458,10,Delaware
2020-05-18,FL,46442,629970,676412,12,Florida
2020-05-18,GA,38081,326208,364289,13,Georgia
2020-05-18,GU,154,4569,4723,66,Guam
2020-05-18,HI,640,41405,42045,15,Hawaii
2020-05-18,IA,14955,88193,103148,19,Iowa
2020-05-18,ID,2419,34253,36672,16,Idaho
2020-05-18,IL,96485,506756,603241,17,Illinois
2020-05-18,IN,28255,155657,183912,18,Indiana
2020-05-18,KS,8340,58650,66990,20,Kansas
2020-05-18,KY,7688,121997,129685,21,Kentucky
2020-05-18,LA,34709,235039,269748,22,Louisiana
2020-05-18,MA,86010,374816,460826,25,Massachusetts
2020-05-18,MD,39762,161744,201506,24,Maryland
2020-05-18,ME,1713,22092,23805,23,Maine
2020-05-18,MI,58812,376115,434927,26,Michigan
2020-05-18,MN,18987,158487,177474,27,Minnesota
2020-05-18,MO,10945,140393,151338,29,Missouri
2020-05-18,MP,21,3399,3420,69,Northern Mariana Islands
2020-05-18,MS,11432,104335,115767,28,Mississippi
2020-05-18,MT,470,27697,28167,30,Montana
2020-05-18,NC,19023,236732,255755,37,North Carolina
2020-05-18,ND,1931,54630,56561,38,North Dakota
2020-05-18,NE,10348,57153,67501,31,Nebraska
2020-05-18,NH,3596,41282,44878,33,New Hampshire
2020-05-18,NJ,148039,357530,505569,34,New Jersey
2020-05-18,NM,5938,127315,133253,35,New Mexico
2020-05-18,NV,6906,74926,81832,32,Nevada
2020-05-18,NY,351371,1088186,1439557,36,New York
2020-05-18,OH,28454,243395,271849,39,Ohio
2020-05-18,OK,5398,118162,123560,40,Oklahoma
2020-05-18,OR,3687,93628,97315,41,Oregon
2020-05-18,PA,63056,277553,340609,42,Pennsylvania
2020-05-18,PR,2710,NA,2710,72,Puerto Rico
2020-05-18,RI,12795,102589,115384,44,Rhode Island
2020-05-18,SC,8942,122617,131559,45,South Carolina
2020-05-18,SD,4027,25018,29045,46,South Dakota
2020-05-18,TN,18011,319417,337428,47,Tennessee
2020-05-18,TX,48693,631152,679845,48,Texas
2020-05-18,UT,7384,166638,174022,49,Utah
2020-05-18,VA,31140,165086,196226,51,Virginia
2020-05-18,VI,69,1278,1347,78,U.S. Virgin Islands
2020-05-18,VT,944,23547,24491,50,Vermont
2020-05-18,WA,19828,290482,310310,53,Washington
2020-05-18,WI,12687,144502,157189,55,Wisconsin
2020-05-18,WV,1491,74544,76035,54,West Virginia
2020-05-18,WY,754,16331,17085,56,Wyoming
2020-05-17,AK,396,34255,34651,02,Alaska
2020-05-17,AL,11771,144579,156350,01,Alabama
2020-05-17,AR,4759,80426,85185,05,Arkansas
2020-05-17,AS,0,105,105,60,American Samoa
2020-05-17,AZ,13937,137824,151761,04,Arizona
2020-05-17,CA,78839,1156404,1235243,06,California
2020-05-17,CO,21633,103915,125548,08,Colorado
2020-05-17,CT,37419,133188,170607,09,Connecticut
2020-05-17,DC,7123,29403,36526,11,District of Columbia
2020-05-17,DE,7670,33195,40865,10,Delaware
2020-05-17,FL,45588,606204,651792,12,Florida
2020-05-17,GA,37701,313474,351175,13,Georgia
2020-05-17,GU,154,4450,4604,66,Guam
2020-05-17,HI,639,41035,41674,15,Hawaii
2020-05-17,IA,14651,85590,100241,19,Iowa
2020-05-17,ID,2419,34253,36672,16,Idaho
2020-05-17,IL,94191,487753,581944,17,Illinois
2020-05-17,IN,27778,149465,177243,18,Indiana
2020-05-17,KS,7886,53706,61592,20,Kansas
2020-05-17,KY,7688,121997,129685,21,Kentucky
2020-05-17,LA,34432,230738,265170,22,Louisiana
2020-05-17,MA,86010,374816,460826,25,Massachusetts
2020-05-17,MD,38804,156122,194926,24,Maryland
2020-05-17,ME,1687,22092,23779,23,Maine
2020-05-17,MI,58278,363548,421826,26,Michigan
2020-05-17,MN,18016,153069,171085,27,Minnesota
2020-05-17,MO,10789,135466,146255,29,Missouri
2020-05-17,MP,21,3318,3339,69,Northern Mariana Islands
2020-05-17,MS,11296,101830,113126,28,Mississippi
2020-05-17,MT,468,26417,26885,30,Montana
2020-05-17,NC,18512,230432,248944,37,North Carolina
2020-05-17,ND,1900,53321,55221,38,North Dakota
2020-05-17,NE,10220,55420,65640,31,Nebraska
2020-05-17,NH,3556,41196,44752,33,New Hampshire
2020-05-17,NJ,146334,341231,487565,34,New Jersey
2020-05-17,NM,5857,122727,128584,35,New Mexico
2020-05-17,NV,6857,73780,80637,32,Nevada
2020-05-17,NY,350121,1063275,1413396,36,New York
2020-05-17,OH,27923,236539,264462,39,Ohio
2020-05-17,OK,5310,118162,123472,40,Oklahoma
2020-05-17,OR,3623,90733,94356,41,Oregon
2020-05-17,PA,62234,270670,332904,42,Pennsylvania
2020-05-17,PR,2646,NA,2646,72,Puerto Rico
2020-05-17,RI,12674,99876,112550,44,Rhode Island
2020-05-17,SC,8816,111670,120486,45,South Carolina
2020-05-17,SD,3987,24572,28559,46,South Dakota
2020-05-17,TN,17388,307892,325280,47,Tennessee
2020-05-17,TX,47784,602571,650355,48,Texas
2020-05-17,UT,7238,163514,170752,49,Utah
2020-05-17,VA,30388,159973,190361,51,Virginia
2020-05-17,VI,69,1278,1347,78,U.S. Virgin Islands
2020-05-17,VT,940,22974,23914,50,Vermont
2020-05-17,WA,19553,282598,302151,53,Washington
2020-05-17,WI,12543,139674,152217,55,Wisconsin
2020-05-17,WV,1490,74000,75490,54,West Virginia
2020-05-17,WY,754,16331,17085,56,Wyoming
2020-05-16,AK,392,32889,33281,02,Alaska
2020-05-16,AL,11523,141971,153494,01,Alabama
2020-05-16,AR,4578,77066,81644,05,Arkansas
2020-05-16,AS,0,105,105,60,American Samoa
2020-05-16,AZ,13631,133157,146788,04,Arizona
2020-05-16,CA,76793,1102333,1179126,06,California
2020-05-16,CO,21232,100608,121840,08,Colorado
2020-05-16,CT,36703,128052,164755,09,Connecticut
2020-05-16,DC,7042,28490,35532,11,District of Columbia
2020-05-16,DE,7547,32211,39758,10,Delaware
2020-05-16,FL,44811,585236,630047,12,Florida
2020-05-16,GA,37147,283922,321069,13,Georgia
2020-05-16,GU,154,4365,4519,66,Guam
2020-05-16,HI,638,40245,40883,15,Hawaii
2020-05-16,IA,14328,81972,96300,19,Iowa
2020-05-16,ID,2389,33299,35688,16,Idaho
2020-05-16,IL,92457,469192,561649,17,Illinois
2020-05-16,IN,27280,144078,171358,18,Indiana
2020-05-16,KS,7886,53706,61592,20,Kansas
2020-05-16,KY,7444,120290,127734,21,Kentucky
2020-05-16,LA,34117,225625,259742,22,Louisiana
2020-05-16,MA,84933,363156,448089,25,Massachusetts
2020-05-16,MD,37968,152207,190175,24,Maryland
2020-05-16,ME,1648,22092,23740,23,Maine
2020-05-16,MI,58023,353156,411179,26,Michigan
2020-05-16,MN,17705,147399,165104,27,Minnesota
2020-05-16,MO,10675,128665,139340,29,Missouri
2020-05-16,MP,21,3318,3339,69,Northern Mariana Islands
2020-05-16,MS,11123,97353,108476,28,Mississippi
2020-05-16,MT,468,25623,26091,30,Montana
2020-05-16,NC,17982,220604,238586,37,North Carolina
2020-05-16,ND,1848,51639,53487,38,North Dakota
2020-05-16,NE,9772,50206,59978,31,Nebraska
2020-05-16,NH,3464,39212,42676,33,New Hampshire
2020-05-16,NJ,145089,330135,475224,34,New Jersey
2020-05-16,NM,5662,118796,124458,35,New Mexico
2020-05-16,NV,6662,67002,73664,32,Nevada
2020-05-16,NY,348232,1030485,1378717,36,New York
2020-05-16,OH,27474,219228,246702,39,Ohio
2020-05-16,OK,5237,118162,123399,40,Oklahoma
2020-05-16,OR,3612,88587,92199,41,Oregon
2020-05-16,PA,61611,266225,327836,42,Pennsylvania
2020-05-16,PR,2589,NA,2589,72,Puerto Rico
2020-05-16,RI,12434,96046,108480,44,Rhode Island
2020-05-16,SC,8407,101209,109616,45,South Carolina
2020-05-16,SD,3959,24217,28176,46,South Dakota
2020-05-16,TN,17288,302913,320201,47,Tennessee
2020-05-16,TX,46999,591740,638739,48,Texas
2020-05-16,UT,7068,159706,166774,49,Utah
2020-05-16,VA,29683,155885,185568,51,Virginia
2020-05-16,VI,69,1194,1263,78,U.S. Virgin Islands
2020-05-16,VT,940,22197,23137,50,Vermont
2020-05-16,WA,19407,280820,300227,53,Washington
2020-05-16,WI,12187,134206,146393,55,Wisconsin
2020-05-16,WV,1457,71936,73393,54,West Virginia
2020-05-16,WY,716,15678,16394,56,Wyoming
2020-05-15,AK,388,32030,32418,02,Alaska
2020-05-15,AL,11216,134847,146063,01,Alabama
2020-05-15,AR,4463,77066,81529,05,Arkansas
2020-05-15,AS,0,105,105,60,American Samoa
2020-05-15,AZ,13169,128832,142001,04,Arizona
2020-05-15,CA,74936,1058970,1133906,06,California
2020-05-15,CO,20838,97192,118030,08,Colorado
2020-05-15,CT,36085,119823,155908,09,Connecticut
2020-05-15,DC,6871,27468,34339,11,District of Columbia
2020-05-15,DE,7373,30905,38278,10,Delaware
2020-05-15,FL,43210,565627,608837,12,Florida
2020-05-15,GA,36681,265193,301874,13,Georgia
2020-05-15,GU,154,4361,4515,66,Guam
2020-05-15,HI,637,38139,38776,15,Hawaii
2020-05-15,IA,14049,79517,93566,19,Iowa
2020-05-15,ID,2351,32394,34745,16,Idaho
2020-05-15,IL,90369,448233,538602,17,Illinois
2020-05-15,IN,26655,138793,165448,18,Indiana
2020-05-15,KS,7886,53706,61592,20,Kansas
2020-05-15,KY,7225,114053,121278,21,Kentucky
2020-05-15,LA,33837,219352,253189,22,Louisiana
2020-05-15,MA,83421,352258,435679,25,Massachusetts
2020-05-15,MD,36986,145840,182826,24,Maryland
2020-05-15,ME,1603,22092,23695,23,Maine
2020-05-15,MI,57687,341827,399514,26,Michigan
2020-05-15,MN,17363,139773,157136,27,Minnesota
2020-05-15,MO,10456,124002,134458,29,Missouri
2020-05-15,MP,19,3306,3325,69,Northern Mariana Islands
2020-05-15,MS,10801,96022,106823,28,Mississippi
2020-05-15,MT,466,24952,25418,30,Montana
2020-05-15,NC,17129,214418,231547,37,North Carolina
2020-05-15,ND,1761,49954,51715,38,North Dakota
2020-05-15,NE,9416,47799,57215,31,Nebraska
2020-05-15,NH,3464,39148,42612,33,New Hampshire
2020-05-15,NJ,143905,319067,462972,34,New Jersey
2020-05-15,NM,5503,114098,119601,35,New Mexico
2020-05-15,NV,6614,65532,72146,32,Nevada
2020-05-15,NY,345813,992235,1338048,36,New York
2020-05-15,OH,26954,219228,246182,39,Ohio
2020-05-15,OK,5086,113106,118192,40,Oklahoma
2020-05-15,OR,3541,85965,89506,41,Oregon
2020-05-15,PA,60622,259210,319832,42,Pennsylvania
2020-05-15,PR,2542,NA,2542,72,Puerto Rico
2020-05-15,RI,12219,92759,104978,44,Rhode Island
2020-05-15,SC,8407,101209,109616,45,South Carolina
2020-05-15,SD,3887,23527,27414,46,South Dakota
2020-05-15,TN,16970,292786,309756,47,Tennessee
2020-05-15,TX,45198,564432,609630,48,Texas
2020-05-15,UT,6913,156305,163218,49,Utah
2020-05-15,VA,28672,149342,178014,51,Virginia
2020-05-15,VI,69,1194,1263,78,U.S. Virgin Islands
2020-05-15,VT,932,21237,22169,50,Vermont
2020-05-15,WA,19224,277963,297187,53,Washington
2020-05-15,WI,11685,128657,140342,55,Wisconsin
2020-05-15,WV,1441,69495,70936,54,West Virginia
2020-05-15,WY,715,15307,16022,56,Wyoming
2020-05-14,AK,387,31375,31762,02,Alaska
2020-05-14,AL,10968,131017,141985,01,Alabama
2020-05-14,AR,4236,71582,75818,05,Arkansas
2020-05-14,AS,0,105,105,60,American Samoa
2020-05-14,AZ,12674,121664,134338,04,Arizona
2020-05-14,CA,73164,1031487,1104651,06,California
2020-05-14,CO,20475,94044,114519,08,Colorado
2020-05-14,CT,35464,114098,149562,09,Connecticut
2020-05-14,DC,6736,26263,32999,11,District of Columbia
2020-05-14,DE,7223,29634,36857,10,Delaware
2020-05-14,FL,43210,565627,608837,12,Florida
2020-05-14,GA,35858,250023,285881,13,Georgia
2020-05-14,GU,153,4226,4379,66,Guam
2020-05-14,HI,638,38243,38881,15,Hawaii
2020-05-14,IA,13675,75619,89294,19,Iowa
2020-05-14,ID,2324,31430,33754,16,Idaho
2020-05-14,IL,87937,424100,512037,17,Illinois
2020-05-14,IN,26053,134186,160239,18,Indiana
2020-05-14,KS,7468,50160,57628,20,Kansas
2020-05-14,KY,7080,110315,117395,21,Kentucky
2020-05-14,LA,33489,214099,247588,22,Louisiana
2020-05-14,MA,82182,342179,424361,25,Massachusetts
2020-05-14,MD,35903,142551,178454,24,Maryland
2020-05-14,ME,1565,22092,23657,23,Maine
2020-05-14,MI,57036,326657,383693,26,Michigan
2020-05-14,MN,16565,131443,148008,27,Minnesota
2020-05-14,MO,10317,116793,127110,29,Missouri
2020-05-14,MP,19,3306,3325,69,Northern Mariana Islands
2020-05-14,MS,10483,94843,105326,28,Mississippi
2020-05-14,MT,462,24087,24549,30,Montana
2020-05-14,NC,16507,202761,219268,37,North Carolina
2020-05-14,ND,1647,48599,50246,38,North Dakota
2020-05-14,NE,9075,44266,53341,31,Nebraska
2020-05-14,NH,3299,35876,39175,33,New Hampshire
2020-05-14,NJ,142704,308992,451696,34,New Jersey
2020-05-14,NM,5364,109647,115011,35,New Mexico
2020-05-14,NV,6499,62985,69484,32,Nevada
2020-05-14,NY,343051,955706,1298757,36,New York
2020-05-14,OH,26357,206995,233352,39,Ohio
2020-05-14,OK,4962,107221,112183,40,Oklahoma
2020-05-14,OR,3479,80571,84050,41,Oregon
2020-05-14,PA,59636,251559,311195,42,Pennsylvania
2020-05-14,PR,2427,NA,2427,72,Puerto Rico
2020-05-14,RI,12016,89585,101601,44,Rhode Island
2020-05-14,SC,8189,94346,102535,45,South Carolina
2020-05-14,SD,3792,22681,26473,46,South Dakota
2020-05-14,TN,16699,285618,302317,47,Tennessee
2020-05-14,TX,43851,543462,587313,48,Texas
2020-05-14,UT,6749,153370,160119,49,Utah
2020-05-14,VA,27813,139017,166830,51,Virginia
2020-05-14,VI,69,1164,1233,78,U.S. Virgin Islands
2020-05-14,VT,931,20497,21428,50,Vermont
2020-05-14,WA,19015,271668,290683,53,Washington
2020-05-14,WI,11275,122598,133873,55,Wisconsin
2020-05-14,WV,1427,67286,68713,54,West Virginia
2020-05-14,WY,701,14729,15430,56,Wyoming
2020-05-13,AK,383,30266,30649,02,Alaska
2020-05-13,AL,10617,125755,136372,01,Alabama
2020-05-13,AR,4164,69051,73215,05,Arkansas
2020-05-13,AS,0,105,105,60,American Samoa
2020-05-13,AZ,12176,115574,127750,04,Arizona
2020-05-13,CA,71141,994451,1065592,06,California
2020-05-13,CO,20157,91093,111250,08,Colorado
2020-05-13,CT,34855,108088,142943,09,Connecticut
2020-05-13,DC,6584,25074,31658,11,District of Columbia
2020-05-13,DE,6952,27801,34753,10,Delaware
2020-05-13,FL,42402,552361,594763,12,Florida
2020-05-13,GA,35332,238572,273904,13,Georgia
2020-05-13,GU,152,4110,4262,66,Guam
2020-05-13,HI,635,37730,38365,15,Hawaii
2020-05-13,IA,13289,72430,85719,19,Iowa
2020-05-13,ID,2293,30835,33128,16,Idaho
2020-05-13,IL,84698,404661,489359,17,Illinois
2020-05-13,IN,25473,128610,154083,18,Indiana
2020-05-13,KS,7468,50160,57628,20,Kansas
2020-05-13,KY,6853,103781,110634,21,Kentucky
2020-05-13,LA,32662,205242,237904,22,Louisiana
2020-05-13,MA,80497,329535,410032,25,Massachusetts
2020-05-13,MD,34812,138762,173574,24,Maryland
2020-05-13,ME,1515,22092,23607,23,Maine
2020-05-13,MI,56458,310242,366700,26,Michigan
2020-05-13,MN,15772,125502,141274,27,Minnesota
2020-05-13,MO,10142,114000,124142,29,Missouri
2020-05-13,MP,19,3021,3040,69,Northern Mariana Islands
2020-05-13,MS,10090,89958,100048,28,Mississippi
2020-05-13,MT,462,23390,23852,30,Montana
2020-05-13,NC,15816,194641,210457,37,North Carolina
2020-05-13,ND,1647,47298,48945,38,North Dakota
2020-05-13,NE,8692,41033,49725,31,Nebraska
2020-05-13,NH,3239,33977,37216,33,New Hampshire
2020-05-13,NJ,141560,299890,441450,34,New Jersey
2020-05-13,NM,5212,105077,110289,35,New Mexico
2020-05-13,NV,6394,60278,66672,32,Nevada
2020-05-13,NY,340661,918246,1258907,36,New York
2020-05-13,OH,25721,200133,225854,39,Ohio
2020-05-13,OK,4852,104275,109127,40,Oklahoma
2020-05-13,OR,3416,80571,83987,41,Oregon
2020-05-13,PA,58698,244171,302869,42,Pennsylvania
2020-05-13,PR,2329,NA,2329,72,Puerto Rico
2020-05-13,RI,11835,86087,97922,44,Rhode Island
2020-05-13,SC,7927,85213,93140,45,South Carolina
2020-05-13,SD,3732,22112,25844,46,South Dakota
2020-05-13,TN,16370,276547,292917,47,Tennessee
2020-05-13,TX,42403,514373,556776,48,Texas
2020-05-13,UT,6620,150166,156786,49,Utah
2020-05-13,VA,26746,134646,161392,51,Virginia
2020-05-13,VI,69,1128,1197,78,U.S. Virgin Islands
2020-05-13,VT,930,19708,20638,50,Vermont
2020-05-13,WA,18780,265798,284578,53,Washington
2020-05-13,WI,10902,117111,128013,55,Wisconsin
2020-05-13,WV,1398,65282,66680,54,West Virginia
2020-05-13,WY,675,14384,15059,56,Wyoming
2020-05-12,AK,383,29578,29961,02,Alaska
2020-05-12,AL,10310,122908,133218,01,Alabama
2020-05-12,AR,4164,66280,70444,05,Arkansas
2020-05-12,AS,0,105,105,60,American Samoa
2020-05-12,AZ,11736,111106,122842,04,Arizona
2020-05-12,CA,69382,963988,1033370,06,California
2020-05-12,CO,19879,88778,108657,08,Colorado
2020-05-12,CT,34333,104091,138424,09,Connecticut
2020-05-12,DC,6485,24565,31050,11,District of Columbia
2020-05-12,DE,6741,26550,33291,10,Delaware
2020-05-12,FL,41923,537681,579604,12,Florida
2020-05-12,GA,34635,227544,262179,13,Georgia
2020-05-12,GU,152,3939,4091,66,Guam
2020-05-12,HI,634,37305,37939,15,Hawaii
2020-05-12,IA,12912,68376,81288,19,Iowa
2020-05-12,ID,2260,30445,32705,16,Idaho
2020-05-12,IL,83021,388670,471691,17,Illinois
2020-05-12,IN,25127,125383,150510,18,Indiana
2020-05-12,KS,7116,46993,54109,20,Kansas
2020-05-12,KY,6677,97347,104024,21,Kentucky
2020-05-12,LA,32050,195962,228012,22,Louisiana
2020-05-12,MA,79332,322164,401496,25,Massachusetts
2020-05-12,MD,34061,135442,169503,24,Maryland
2020-05-12,ME,1477,22092,23569,23,Maine
2020-05-12,MI,55641,291701,347342,26,Michigan
2020-05-12,MN,15043,118934,133977,27,Minnesota
2020-05-12,MO,10006,111290,121296,29,Missouri
2020-05-12,MP,19,2854,2873,69,Northern Mariana Islands
2020-05-12,MS,9908,87784,97692,28,Mississippi
2020-05-12,MT,461,22574,23035,30,Montana
2020-05-12,NC,15346,186898,202244,37,North Carolina
2020-05-12,ND,1571,46261,47832,38,North Dakota
2020-05-12,NE,8572,39371,47943,31,Nebraska
2020-05-12,NH,3160,32401,35561,33,New Hampshire
2020-05-12,NJ,140743,292317,433060,34,New Jersey
2020-05-12,NM,5069,101652,106721,35,New Mexico
2020-05-12,NV,6311,57764,64075,32,Nevada
2020-05-12,NY,338485,886628,1225113,36,New York
2020-05-12,OH,25250,192481,217731,39,Ohio
2020-05-12,OK,4732,91379,96111,40,Oklahoma
2020-05-12,OR,3286,74320,77606,41,Oregon
2020-05-12,PA,57991,237989,295980,42,Pennsylvania
2020-05-12,PR,2299,NA,2299,72,Puerto Rico
2020-05-12,RI,11614,83625,95239,44,Rhode Island
2020-05-12,SC,7927,85213,93140,45,South Carolina
2020-05-12,SD,3663,21534,25197,46,South Dakota
2020-05-12,TN,16111,267713,283824,47,Tennessee
2020-05-12,TX,41048,497124,538172,48,Texas
2020-05-12,UT,6432,147053,153485,49,Utah
2020-05-12,VA,25800,129529,155329,51,Virginia
2020-05-12,VI,69,1115,1184,78,U.S. Virgin Islands
2020-05-12,VT,929,19107,20036,50,Vermont
2020-05-12,WA,18562,259374,277936,53,Washington
2020-05-12,WI,10611,112748,123359,55,Wisconsin
2020-05-12,WV,1371,63698,65069,54,West Virginia
2020-05-12,WY,675,14384,15059,56,Wyoming
2020-05-11,AK,381,28299,28680,02,Alaska
2020-05-11,AL,10009,119435,129444,01,Alabama
2020-05-11,AR,4034,64996,69030,05,Arkansas
2020-05-11,AS,0,105,105,60,American Samoa
2020-05-11,AZ,11380,105084,116464,04,Arizona
2020-05-11,CA,67939,923958,991897,06,California
2020-05-11,CO,19899,88891,108790,08,Colorado
2020-05-11,CT,33765,98743,132508,09,Connecticut
2020-05-11,DC,6389,23872,30261,11,District of Columbia
2020-05-11,DE,6565,25363,31928,10,Delaware
2020-05-11,FL,40982,520075,561057,12,Florida
2020-05-11,GA,33927,217361,251288,13,Georgia
2020-05-11,GU,151,3838,3989,66,Guam
2020-05-11,HI,632,37051,37683,15,Hawaii
2020-05-11,IA,12373,65419,77792,19,Iowa
2020-05-11,ID,2230,29912,32142,16,Idaho
2020-05-11,IL,79007,363418,442425,17,Illinois
2020-05-11,IN,24627,122061,146688,18,Indiana
2020-05-11,KS,7116,46993,54109,20,Kansas
2020-05-11,KY,6440,80483,86923,21,Kentucky
2020-05-11,LA,31815,189015,220830,22,Louisiana
2020-05-11,MA,78462,316266,394728,25,Massachusetts
2020-05-11,MD,33373,131407,164780,24,Maryland
2020-05-11,ME,1462,22092,23554,23,Maine
2020-05-11,MI,54004,278293,332297,26,Michigan
2020-05-11,MN,14379,115585,129964,27,Minnesota
2020-05-11,MO,9918,105702,115620,29,Missouri
2020-05-11,MP,19,2676,2695,69,Northern Mariana Islands
2020-05-11,MS,9674,86211,95885,28,Mississippi
2020-05-11,MT,459,22113,22572,30,Montana
2020-05-11,NC,15045,180820,195865,37,North Carolina
2020-05-11,ND,1518,45496,47014,38,North Dakota
2020-05-11,NE,8315,37924,46239,31,Nebraska
2020-05-11,NH,3160,31723,34883,33,New Hampshire
2020-05-11,NJ,139945,285988,425933,34,New Jersey
2020-05-11,NM,4863,97635,102498,35,New Mexico
2020-05-11,NV,6152,53932,60084,32,Nevada
2020-05-11,NY,337055,867596,1204651,36,New York
2020-05-11,OH,24777,185753,210530,39,Ohio
2020-05-11,OK,4613,91379,95992,40,Oklahoma
2020-05-11,OR,3286,74320,77606,41,Oregon
2020-05-11,PA,57154,231704,288858,42,Pennsylvania
2020-05-11,PR,2256,NA,2256,72,Puerto Rico
2020-05-11,RI,11450,81882,93332,44,Rhode Island
2020-05-11,SC,7653,76804,84457,45,South Carolina
2020-05-11,SD,3614,20964,24578,46,South Dakota
2020-05-11,TN,15544,257733,273277,47,Tennessee
2020-05-11,TX,39869,485828,525697,48,Texas
2020-05-11,UT,6362,144223,150585,49,Utah
2020-05-11,VA,25070,125547,150617,51,Virginia
2020-05-11,VI,69,1110,1179,78,U.S. Virgin Islands
2020-05-11,VT,927,18797,19724,50,Vermont
2020-05-11,WA,18354,253148,271502,53,Washington
2020-05-11,WI,10418,108033,118451,55,Wisconsin
2020-05-11,WV,1366,62103,63469,54,West Virginia
2020-05-11,WY,662,11403,12065,56,Wyoming
2020-05-10,AK,379,26985,27364,02,Alaska
2020-05-10,AL,9777,117644,127421,01,Alabama
2020-05-10,AR,3747,61781,65528,05,Arkansas
2020-05-10,AS,0,83,83,60,American Samoa
2020-05-10,AZ,11119,99258,110377,04,Arizona
2020-05-10,CA,66680,888984,955664,06,California
2020-05-10,CO,19703,84374,104077,08,Colorado
2020-05-10,CT,33554,96638,130192,09,Connecticut
2020-05-10,DC,6272,23298,29570,11,District of Columbia
2020-05-10,DE,6447,24592,31039,10,Delaware
2020-05-10,FL,40596,498352,538948,12,Florida
2020-05-10,GA,33441,210106,243547,13,Georgia
2020-05-10,GU,151,3643,3794,66,Guam
2020-05-10,HI,631,36639,37270,15,Hawaii
2020-05-10,IA,11959,62215,74174,19,Iowa
2020-05-10,ID,2230,29912,32142,16,Idaho
2020-05-10,IL,77741,352243,429984,17,Illinois
2020-05-10,IN,24126,115903,140029,18,Indiana
2020-05-10,KS,6948,45557,52505,20,Kansas
2020-05-10,KY,6440,80483,86923,21,Kentucky
2020-05-10,LA,31600,184272,215872,22,Louisiana
2020-05-10,MA,77793,310596,388389,25,Massachusetts
2020-05-10,MD,32587,127344,159931,24,Maryland
2020-05-10,ME,1436,22092,23528,23,Maine
2020-05-10,MI,53033,267417,320450,26,Michigan
2020-05-10,MN,13552,111109,124661,27,Minnesota
2020-05-10,MO,9844,105702,115546,29,Missouri
2020-05-10,MP,16,2321,2337,69,Northern Mariana Islands
2020-05-10,MS,9501,72101,81602,28,Mississippi
2020-05-10,MT,458,21246,21704,30,Montana
2020-05-10,NC,14764,177371,192135,37,North Carolina
2020-05-10,ND,1491,43378,44869,38,North Dakota
2020-05-10,NE,8234,37335,45569,31,Nebraska
2020-05-10,NH,3011,30442,33453,33,New Hampshire
2020-05-10,NJ,138532,173915,312447,34,New Jersey
2020-05-10,NM,4778,92275,97053,35,New Mexico
2020-05-10,NV,6098,52711,58809,32,Nevada
2020-05-10,NY,335395,847603,1182998,36,New York
2020-05-10,OH,24081,180781,204862,39,Ohio
2020-05-10,OK,4589,91379,95968,40,Oklahoma
2020-05-10,OR,3228,72279,75507,41,Oregon
2020-05-10,PA,56611,227772,284383,42,Pennsylvania
2020-05-10,PR,2198,NA,2198,72,Puerto Rico
2020-05-10,RI,11274,79939,91213,44,Rhode Island
2020-05-10,SC,7653,76804,84457,45,South Carolina
2020-05-10,SD,3517,20377,23894,46,South Dakota
2020-05-10,TN,14985,246884,261869,47,Tennessee
2020-05-10,TX,38869,462907,501776,48,Texas
2020-05-10,UT,6251,140259,146510,49,Utah
2020-05-10,VA,24081,118974,143055,51,Virginia
2020-05-10,VI,69,1102,1171,78,U.S. Virgin Islands
2020-05-10,VT,926,18167,19093,50,Vermont
2020-05-10,WA,18073,247364,265437,53,Washington
2020-05-10,WI,10219,105163,115382,55,Wisconsin
2020-05-10,WV,1360,61284,62644,54,West Virginia
2020-05-10,WY,661,11403,12064,56,Wyoming
2020-05-09,AK,378,26071,26449,02,Alaska
2020-05-09,AL,9567,115927,125494,01,Alabama
2020-05-09,AR,3747,61781,65528,05,Arkansas
2020-05-09,AS,0,83,83,60,American Samoa
2020-05-09,AZ,10960,94850,105810,04,Arizona
2020-05-09,CA,64561,848009,912570,06,California
2020-05-09,CO,18827,77945,96772,08,Colorado
2020-05-09,CT,32984,90585,123569,09,Connecticut
2020-05-09,DC,6102,22081,28183,11,District of Columbia
2020-05-09,DE,6277,23019,29296,10,Delaware
2020-05-09,FL,40001,487730,527731,12,Florida
2020-05-09,GA,32532,202792,235324,13,Georgia
2020-05-09,GU,151,3643,3794,66,Guam
2020-05-09,HI,629,35633,36262,15,Hawaii
2020-05-09,IA,11671,59805,71476,19,Iowa
2020-05-09,ID,2205,29601,31806,16,Idaho
2020-05-09,IL,76085,340246,416331,17,Illinois
2020-05-09,IN,23732,111954,135686,18,Indiana
2020-05-09,KS,6751,43182,49933,20,Kansas
2020-05-09,KY,6288,80159,86447,21,Kentucky
2020-05-09,LA,31417,180740,212157,22,Louisiana
2020-05-09,MA,76743,299794,376537,25,Massachusetts
2020-05-09,MD,31534,124494,156028,24,Maryland
2020-05-09,ME,1408,22092,23500,23,Maine
2020-05-09,MI,52732,259265,311997,26,Michigan
2020-05-09,MN,13321,106040,119361,27,Minnesota
2020-05-09,MO,9666,99232,108898,29,Missouri
2020-05-09,MP,16,2321,2337,69,Northern Mariana Islands
2020-05-09,MS,9378,72101,81479,28,Mississippi
2020-05-09,MT,458,20871,21329,30,Montana
2020-05-09,NC,14360,172002,186362,37,North Carolina
2020-05-09,ND,1464,42469,43933,38,North Dakota
2020-05-09,NE,7831,35145,42976,31,Nebraska
2020-05-09,NH,2947,29351,32298,33,New Hampshire
2020-05-09,NJ,137085,168121,305206,34,New Jersey
2020-05-09,NM,4673,88589,93262,35,New Mexico
2020-05-09,NV,6028,50083,56111,32,Nevada
2020-05-09,NY,333122,820646,1153768,36,New York
2020-05-09,OH,23697,172973,196670,39,Ohio
2020-05-09,OK,4490,91379,95869,40,Oklahoma
2020-05-09,OR,3160,71460,74620,41,Oregon
2020-05-09,PA,55316,221791,277107,42,Pennsylvania
2020-05-09,PR,2173,NA,2173,72,Puerto Rico
2020-05-09,RI,10989,76826,87815,44,Rhode Island
2020-05-09,SC,7531,73432,80963,45,South Carolina
2020-05-09,SD,3393,19559,22952,46,South Dakota
2020-05-09,TN,14768,237980,252748,47,Tennessee
2020-05-09,TX,37860,451434,489294,48,Texas
2020-05-09,UT,6103,137191,143294,49,Utah
2020-05-09,VA,23196,113953,137149,51,Virginia
2020-05-09,VI,68,1024,1092,78,U.S. Virgin Islands
2020-05-09,VT,926,17690,18616,50,Vermont
2020-05-09,WA,17906,246192,264098,53,Washington
2020-05-09,WI,9939,101935,111874,55,Wisconsin
2020-05-09,WV,1335,59662,60997,54,West Virginia
2020-05-09,WY,644,11403,12047,56,Wyoming
2020-05-08,AK,377,25096,25473,02,Alaska
2020-05-08,AL,9221,110893,120114,01,Alabama
2020-05-08,AR,3694,60300,63994,05,Arkansas
2020-05-08,AS,0,83,83,60,American Samoa
2020-05-08,AZ,10526,90599,101125,04,Arizona
2020-05-08,CA,62512,812760,875272,06,California
2020-05-08,CO,18801,75735,94536,08,Colorado
2020-05-08,CT,32411,88130,120541,09,Connecticut
2020-05-08,DC,5899,21216,27115,11,District of Columbia
2020-05-08,DE,6111,22153,28264,10,Delaware
2020-05-08,FL,39199,474142,513341,12,Florida
2020-05-08,GA,32106,195461,227567,13,Georgia
2020-05-08,GU,151,3626,3777,66,Guam
2020-05-08,HI,629,35989,36618,15,Hawaii
2020-05-08,IA,11457,58804,70261,19,Iowa
2020-05-08,ID,2178,29092,31270,16,Idaho
2020-05-08,IL,73760,325954,399714,17,Illinois
2020-05-08,IN,23146,106982,130128,18,Indiana
2020-05-08,KS,6501,41207,47708,20,Kansas
2020-05-08,KY,6129,75272,81401,21,Kentucky
2020-05-08,LA,30855,171561,202416,22,Louisiana
2020-05-08,MA,75333,290690,366023,25,Massachusetts
2020-05-08,MD,30485,121702,152187,24,Maryland
2020-05-08,ME,1374,22092,23466,23,Maine
2020-05-08,MI,52349,248142,300491,26,Michigan
2020-05-08,MN,13040,101408,114448,27,Minnesota
2020-05-08,MO,9489,99232,108721,29,Missouri
2020-05-08,MP,15,2321,2336,69,Northern Mariana Islands
2020-05-08,MS,9090,72101,81191,28,Mississippi
2020-05-08,MT,458,20487,20945,30,Montana
2020-05-08,NC,13868,164745,178613,37,North Carolina
2020-05-08,ND,1425,41076,42501,38,North Dakota
2020-05-08,NE,7190,33222,40412,31,Nebraska
2020-05-08,NH,2843,27829,30672,33,New Hampshire
2020-05-08,NJ,135454,163305,298759,34,New Jersey
2020-05-08,NM,4493,84539,89032,35,New Mexico
2020-05-08,NV,5884,47460,53344,32,Nevada
2020-05-08,NY,330407,791136,1121543,36,New York
2020-05-08,OH,23016,161300,184316,39,Ohio
2020-05-08,OK,4424,85433,89857,40,Oklahoma
2020-05-08,OR,3068,69625,72693,41,Oregon
2020-05-08,PA,54238,216321,270559,42,Pennsylvania
2020-05-08,PR,2156,NA,2156,72,Puerto Rico
2020-05-08,RI,10779,74487,85266,44,Rhode Island
2020-05-08,SC,7142,66300,73442,45,South Carolina
2020-05-08,SD,3144,18149,21293,46,South Dakota
2020-05-08,TN,14441,229137,243578,47,Tennessee
2020-05-08,TX,36609,440509,477118,48,Texas
2020-05-08,UT,5919,132769,138688,49,Utah
2020-05-08,VA,22342,107603,129945,51,Virginia
2020-05-08,VI,68,1024,1092,78,U.S. Virgin Islands
2020-05-08,VT,918,17222,18140,50,Vermont
2020-05-08,WA,17758,244000,261758,53,Washington
2020-05-08,WI,9590,97265,106855,55,Wisconsin
2020-05-08,WV,1310,58126,59436,54,West Virginia
2020-05-08,WY,635,11403,12038,56,Wyoming
2020-05-07,AK,374,23967,24341,02,Alaska
2020-05-07,AL,8898,106275,115173,01,Alabama
2020-05-07,AR,3611,56384,59995,05,Arkansas
2020-05-07,AS,0,83,83,60,American Samoa
2020-05-07,AZ,9945,86489,96434,04,Arizona
2020-05-07,CA,60614,782260,842874,06,California
2020-05-07,CO,17830,73517,91347,08,Colorado
2020-05-07,CT,31784,84390,116174,09,Connecticut
2020-05-07,DC,5654,20202,25856,11,District of Columbia
2020-05-07,DE,5939,21387,27326,10,Delaware
2020-05-07,FL,38828,454122,492950,12,Florida
2020-05-07,GA,31439,185864,217303,13,Georgia
2020-05-07,GU,151,3564,3715,66,Guam
2020-05-07,HI,626,34915,35541,15,Hawaii
2020-05-07,IA,11059,55368,66427,19,Iowa
2020-05-07,ID,2158,28732,30890,16,Idaho
2020-05-07,IL,70873,308170,379043,17,Illinois
2020-05-07,IN,22503,102279,124782,18,Indiana
2020-05-07,KS,6144,38678,44822,20,Kansas
2020-05-07,KY,5934,72672,78606,21,Kentucky
2020-05-07,LA,30652,170115,200767,22,Louisiana
2020-05-07,MA,73721,277911,351632,25,Massachusetts
2020-05-07,MD,29374,119226,148600,24,Maryland
2020-05-07,ME,1330,22092,23422,23,Maine
2020-05-07,MI,51731,236184,287915,26,Michigan
2020-05-07,MN,12328,97244,109572,27,Minnesota
2020-05-07,MO,9341,94281,103622,29,Missouri
2020-05-07,MP,15,1783,1798,69,Northern Mariana Islands
2020-05-07,MS,8686,72101,80787,28,Mississippi
2020-05-07,MT,456,19791,20247,30,Montana
2020-05-07,NC,13397,157931,171328,37,North Carolina
2020-05-07,ND,1371,39496,40867,38,North Dakota
2020-05-07,NE,6771,30987,37758,31,Nebraska
2020-05-07,NH,2740,26066,28806,33,New Hampshire
2020-05-07,NJ,133635,159023,292658,34,New Jersey
2020-05-07,NM,4291,81393,85684,35,New Mexico
2020-05-07,NV,5766,45591,51357,32,Nevada
2020-05-07,NY,327649,762267,1089916,36,New York
2020-05-07,OH,22131,153928,176059,39,Ohio
2020-05-07,OK,4330,82557,86887,40,Oklahoma
2020-05-07,OR,2989,67469,70458,41,Oregon
2020-05-07,PA,52915,209873,262788,42,Pennsylvania
2020-05-07,PR,2031,NA,2031,72,Puerto Rico
2020-05-07,RI,10530,71788,82318,44,Rhode Island
2020-05-07,SC,6936,70546,77482,45,South Carolina
2020-05-07,SD,2905,17209,20114,46,South Dakota
2020-05-07,TN,14096,222232,236328,47,Tennessee
2020-05-07,TX,35390,419772,455162,48,Texas
2020-05-07,UT,5724,128819,134543,49,Utah
2020-05-07,VA,21570,101582,123152,51,Virginia
2020-05-07,VI,66,990,1056,78,U.S. Virgin Islands
2020-05-07,VT,916,16690,17606,50,Vermont
2020-05-07,WA,17553,237899,255452,53,Washington
2020-05-07,WI,9215,93035,102250,55,Wisconsin
2020-05-07,WV,1287,56234,57521,54,West Virginia
2020-05-07,WY,631,11403,12034,56,Wyoming
2020-05-06,AK,372,23283,23655,02,Alaska
2020-05-06,AL,8581,100935,109516,01,Alabama
2020-05-06,AR,3568,55435,59003,05,Arkansas
2020-05-06,AS,0,83,83,60,American Samoa
2020-05-06,AZ,9707,82030,91737,04,Arizona
2020-05-06,CA,58815,750221,809036,06,California
2020-05-06,CO,17364,68612,85976,08,Colorado
2020-05-06,CT,30995,80452,111447,09,Connecticut
2020-05-06,DC,5461,19523,24984,11,District of Columbia
2020-05-06,DE,5778,20690,26468,10,Delaware
2020-05-06,FL,38002,442049,480051,12,Florida
2020-05-06,GA,30696,173441,204137,13,Georgia
2020-05-06,GU,151,3476,3627,66,Guam
2020-05-06,HI,625,34574,35199,15,Hawaii
2020-05-06,IA,10404,52767,63171,19,Iowa
2020-05-06,ID,2127,28418,30545,16,Idaho
2020-05-06,IL,68232,293028,361260,17,Illinois
2020-05-06,IN,21870,98626,120496,18,Indiana
2020-05-06,KS,5734,36380,42114,20,Kansas
2020-05-06,KY,5822,55192,61014,21,Kentucky
2020-05-06,LA,30399,164273,194672,22,Louisiana
2020-05-06,MA,72025,267614,339639,25,Massachusetts
2020-05-06,MD,28163,115849,144012,24,Maryland
2020-05-06,ME,1254,22092,23346,23,Maine
2020-05-06,MI,51131,224563,275694,26,Michigan
2020-05-06,MN,11510,93047,104557,27,Minnesota
2020-05-06,MO,9102,91645,100747,29,Missouri
2020-05-06,MP,15,1783,1798,69,Northern Mariana Islands
2020-05-06,MS,8424,72101,80525,28,Mississippi
2020-05-06,MT,456,19248,19704,30,Montana
2020-05-06,NC,12758,151724,164482,37,North Carolina
2020-05-06,ND,1323,37309,38632,38,North Dakota
2020-05-06,NE,6438,29690,36128,31,Nebraska
2020-05-06,NH,2636,25097,27733,33,New Hampshire
2020-05-06,NJ,131890,157030,288920,34,New Jersey
2020-05-06,NM,4138,79113,83251,35,New Mexico
2020-05-06,NV,5663,43612,49275,32,Nevada
2020-05-06,NY,323978,731943,1055921,36,New York
2020-05-06,OH,21576,147353,168929,39,Ohio
2020-05-06,OK,4201,78689,82890,40,Oklahoma
2020-05-06,OR,2916,65060,67976,41,Oregon
2020-05-06,PA,51845,204495,256340,42,Pennsylvania
2020-05-06,PR,1968,NA,1968,72,Puerto Rico
2020-05-06,RI,10205,69168,79373,44,Rhode Island
2020-05-06,SC,6936,70546,77482,45,South Carolina
2020-05-06,SD,2779,16637,19416,46,South Dakota
2020-05-06,TN,13938,213163,227101,47,Tennessee
2020-05-06,TX,34422,404516,438938,48,Texas
2020-05-06,UT,5595,125407,131002,49,Utah
2020-05-06,VA,20256,93452,113708,51,Virginia
2020-05-06,VI,66,990,1056,78,U.S. Virgin Islands
2020-05-06,VT,914,16281,17195,50,Vermont
2020-05-06,WA,17356,232193,249549,53,Washington
2020-05-06,WI,8901,87826,96727,55,Wisconsin
2020-05-06,WV,1248,54536,55784,54,West Virginia
2020-05-06,WY,604,11403,12007,56,Wyoming
2020-05-05,AK,371,22321,22692,02,Alaska
2020-05-05,AL,8285,98481,106766,01,Alabama
2020-05-05,AR,3496,51139,54635,05,Arkansas
2020-05-05,AS,0,83,83,60,American Samoa
2020-05-05,AZ,9305,78955,88260,04,Arizona
2020-05-05,CA,56212,723690,779902,06,California
2020-05-05,CO,16907,68097,85004,08,Colorado
2020-05-05,CT,30621,78022,108643,09,Connecticut
2020-05-05,DC,5322,19007,24329,11,District of Columbia
2020-05-05,DE,5371,19309,24680,10,Delaware
2020-05-05,FL,37439,428252,465691,12,Florida
2020-05-05,GA,29711,171172,200883,13,Georgia
2020-05-05,GU,149,3341,3490,66,Guam
2020-05-05,HI,621,33378,33999,15,Hawaii
2020-05-05,IA,10111,50458,60569,19,Iowa
2020-05-05,ID,2106,28202,30308,16,Idaho
2020-05-05,IL,65962,280324,346286,17,Illinois
2020-05-05,IN,21033,94801,115834,18,Indiana
2020-05-05,KS,5458,34634,40092,20,Kansas
2020-05-05,KY,5245,54802,60047,21,Kentucky
2020-05-05,LA,29996,158235,188231,22,Louisiana
2020-05-05,MA,70271,263078,333349,25,Massachusetts
2020-05-05,MD,27117,112986,140103,24,Maryland
2020-05-05,ME,1226,19546,20772,23,Maine
2020-05-05,MI,50497,213091,263588,26,Michigan
2020-05-05,MN,10876,89202,100078,27,Minnesota
2020-05-05,MO,8916,86150,95066,29,Missouri
2020-05-05,MP,14,1783,1797,69,Northern Mariana Islands
2020-05-05,MS,8207,72101,80308,28,Mississippi
2020-05-05,MT,456,14816,15272,30,Montana
2020-05-05,NC,12256,139544,151800,37,North Carolina
2020-05-05,ND,1266,35155,36421,38,North Dakota
2020-05-05,NE,6083,28526,34609,31,Nebraska
2020-05-05,NH,2588,24282,26870,33,New Hampshire
2020-05-05,NJ,130593,157030,287623,34,New Jersey
2020-05-05,NM,4031,77689,81720,35,New Mexico
2020-05-05,NV,5594,42290,47884,32,Nevada
2020-05-05,NY,321192,707707,1028899,36,New York
2020-05-05,OH,20969,139766,160735,39,Ohio
2020-05-05,OK,4127,75290,79417,40,Oklahoma
2020-05-05,OR,2839,62585,65424,41,Oregon
2020-05-05,PA,50957,199925,250882,42,Pennsylvania
2020-05-05,PR,1924,9313,11237,72,Puerto Rico
2020-05-05,RI,9933,66502,76435,44,Rhode Island
2020-05-05,SC,6757,61014,67771,45,South Carolina
2020-05-05,SD,2721,16301,19022,46,South Dakota
2020-05-05,TN,13690,205172,218862,47,Tennessee
2020-05-05,TX,33369,393841,427210,48,Texas
2020-05-05,UT,5449,121266,126715,49,Utah
2020-05-05,VA,20256,93452,113708,51,Virginia
2020-05-05,VI,66,973,1039,78,U.S. Virgin Islands
2020-05-05,VT,909,16065,16974,50,Vermont
2020-05-05,WA,17113,225215,242328,53,Washington
2020-05-05,WI,8566,83967,92533,55,Wisconsin
2020-05-05,WV,1238,53585,54823,54,West Virginia
2020-05-05,WY,596,10319,10915,56,Wyoming
2020-05-04,AK,370,21353,21723,02,Alaska
2020-05-04,AL,8025,95092,103117,01,Alabama
2020-05-04,AR,3458,50984,54442,05,Arkansas
2020-05-04,AS,0,83,83,60,American Samoa
2020-05-04,AZ,8919,76334,85253,04,Arizona
2020-05-04,CA,54937,692937,747874,06,California
2020-05-04,CO,16635,66455,83090,08,Colorado
2020-05-04,CT,29287,73206,102493,09,Connecticut
2020-05-04,DC,5170,18625,23795,11,District of Columbia
2020-05-04,DE,5288,18822,24110,10,Delaware
2020-05-04,FL,36897,407373,444270,12,Florida
2020-05-04,GA,29368,153957,183325,13,Georgia
2020-05-04,GU,149,3242,3391,66,Guam
2020-05-04,HI,620,33246,33866,15,Hawaii
2020-05-04,IA,9703,47458,57161,19,Iowa
2020-05-04,ID,2061,27746,29807,16,Idaho
2020-05-04,IL,63840,269307,333147,17,Illinois
2020-05-04,IN,20507,92790,113297,18,Indiana
2020-05-04,KS,5245,33358,38603,20,Kansas
2020-05-04,KY,5130,53279,58409,21,Kentucky
2020-05-04,LA,29673,151258,180931,22,Louisiana
2020-05-04,MA,69087,255181,324268,25,Massachusetts
2020-05-04,MD,26408,110587,136995,24,Maryland
2020-05-04,ME,1205,19546,20751,23,Maine
2020-05-04,MI,49809,202671,252480,26,Michigan
2020-05-04,MN,10235,86677,96912,27,Minnesota
2020-05-04,MO,8754,82697,91451,29,Missouri
2020-05-04,MP,14,1321,1335,69,Northern Mariana Islands
2020-05-04,MS,7877,71800,79677,28,Mississippi
2020-05-04,MT,457,14631,15088,30,Montana
2020-05-04,NC,11848,134591,146439,37,North Carolina
2020-05-04,ND,1225,33529,34754,38,North Dakota
2020-05-04,NE,5910,27844,33754,31,Nebraska
2020-05-04,NH,2588,24282,26870,33,New Hampshire
2020-05-04,NJ,128269,148951,277220,34,New Jersey
2020-05-04,NM,3850,74127,77977,35,New Mexico
2020-05-04,NV,5491,40675,46166,32,Nevada
2020-05-04,NY,318953,688357,1007310,36,New York
2020-05-04,OH,20474,134681,155155,39,Ohio
2020-05-04,OK,4044,59804,63848,40,Oklahoma
2020-05-04,OR,2759,60698,63457,41,Oregon
2020-05-04,PA,50092,195498,245590,42,Pennsylvania
2020-05-04,PR,1843,9313,11156,72,Puerto Rico
2020-05-04,RI,9652,64484,74136,44,Rhode Island
2020-05-04,SC,6626,57562,64188,45,South Carolina
2020-05-04,SD,2668,16045,18713,46,South Dakota
2020-05-04,TN,13571,197872,211443,47,Tennessee
2020-05-04,TX,32332,375066,407398,48,Texas
2020-05-04,UT,5317,119344,124661,49,Utah
2020-05-04,VA,19492,92801,112293,51,Virginia
2020-05-04,VI,66,965,1031,78,U.S. Virgin Islands
2020-05-04,VT,906,15889,16795,50,Vermont
2020-05-04,WA,16853,218912,235765,53,Washington
2020-05-04,WI,8236,80467,88703,55,Wisconsin
2020-05-04,WV,1206,52033,53239,54,West Virginia
2020-05-04,WY,586,9868,10454,56,Wyoming
2020-05-03,AK,368,21210,21578,02,Alaska
2020-05-03,AL,7725,84775,92500,01,Alabama
2020-05-03,AR,3431,49459,52890,05,Arkansas
2020-05-03,AS,0,57,57,60,American Samoa
2020-05-03,AZ,8640,72479,81119,04,Arizona
2020-05-03,CA,53616,662135,715751,06,California
2020-05-03,CO,16225,63681,79906,08,Colorado
2020-05-03,CT,29287,73206,102493,09,Connecticut
2020-05-03,DC,5016,18086,23102,11,District of Columbia
2020-05-03,DE,5208,18529,23737,10,Delaware
2020-05-03,FL,36078,392111,428189,12,Florida
2020-05-03,GA,28602,146494,175096,13,Georgia
2020-05-03,GU,150,3152,3302,66,Guam
2020-05-03,HI,620,32330,32950,15,Hawaii
2020-05-03,IA,9169,44017,53186,19,Iowa
2020-05-03,ID,2061,27746,29807,16,Idaho
2020-05-03,IL,61499,257814,319313,17,Illinois
2020-05-03,IN,19933,88926,108859,18,Indiana
2020-05-03,KS,5030,31748,36778,20,Kansas
2020-05-03,KY,4879,52770,57649,21,Kentucky
2020-05-03,LA,29340,146820,176160,22,Louisiana
2020-05-03,MA,68087,246559,314646,25,Massachusetts
2020-05-03,MD,25462,107332,132794,24,Maryland
2020-05-03,ME,1185,19546,20731,23,Maine
2020-05-03,MI,49029,195361,244390,26,Michigan
2020-05-03,MN,9411,83433,92844,27,Minnesota
2020-05-03,MO,8386,74590,82976,29,Missouri
2020-05-03,MP,14,1321,1335,69,Northern Mariana Islands
2020-05-03,MS,7550,70043,77593,28,Mississippi
2020-05-03,MT,455,14552,15007,30,Montana
2020-05-03,NC,11664,132171,143835,37,North Carolina
2020-05-03,ND,1191,32162,33353,38,North Dakota
2020-05-03,NE,5326,25936,31262,31,Nebraska
2020-05-03,NH,2429,25964,28393,33,New Hampshire
2020-05-03,NJ,126744,148322,275066,34,New Jersey
2020-05-03,NM,3732,71212,74944,35,New Mexico
2020-05-03,NV,5426,39843,45269,32,Nevada
2020-05-03,NY,316415,669496,985911,36,New York
2020-05-03,OH,19914,130252,150166,39,Ohio
2020-05-03,OK,3972,59804,63776,40,Oklahoma
2020-05-03,OR,2680,59374,62054,41,Oregon
2020-05-03,PA,49267,191374,240641,42,Pennsylvania
2020-05-03,PR,1808,9313,11121,72,Puerto Rico
2020-05-03,RI,9477,62450,71927,44,Rhode Island
2020-05-03,SC,6626,57562,64188,45,South Carolina
2020-05-03,SD,2631,15786,18417,46,South Dakota
2020-05-03,TN,13177,191430,204607,47,Tennessee
2020-05-03,TX,31548,359012,390560,48,Texas
2020-05-03,UT,5175,116927,122102,49,Utah
2020-05-03,VA,18671,89331,108002,51,Virginia
2020-05-03,VI,66,951,1017,78,U.S. Virgin Islands
2020-05-03,VT,901,15570,16471,50,Vermont
2020-05-03,WA,16594,212185,228779,53,Washington
2020-05-03,WI,7964,77997,85961,55,Wisconsin
2020-05-03,WV,1191,50447,51638,54,West Virginia
2020-05-03,WY,579,9640,10219,56,Wyoming
2020-05-02,AK,365,21034,21399,02,Alaska
2020-05-02,AL,7434,84775,92209,01,Alabama
2020-05-02,AR,3372,48210,51582,05,Arkansas
2020-05-02,AS,0,57,57,60,American Samoa
2020-05-02,AZ,8364,69633,77997,04,Arizona
2020-05-02,CA,52197,634606,686803,06,California
2020-05-02,CO,15768,61181,76949,08,Colorado
2020-05-02,CT,28764,71493,100257,09,Connecticut
2020-05-02,DC,4797,17207,22004,11,District of Columbia
2020-05-02,DE,5038,18074,23112,10,Delaware
2020-05-02,FL,35463,380549,416012,12,Florida
2020-05-02,GA,28306,146494,174800,13,Georgia
2020-05-02,GU,148,3040,3188,66,Guam
2020-05-02,HI,619,31366,31985,15,Hawaii
2020-05-02,IA,8641,37708,46349,19,Iowa
2020-05-02,ID,2035,27455,29490,16,Idaho
2020-05-02,IL,58505,241391,299896,17,Illinois
2020-05-02,IN,19295,84846,104141,18,Indiana
2020-05-02,KS,4746,30196,34942,20,Kansas
2020-05-02,KY,4879,52770,57649,21,Kentucky
2020-05-02,LA,29140,143718,172858,22,Louisiana
2020-05-02,MA,66263,232731,298994,25,Massachusetts
2020-05-02,MD,24473,101049,125522,24,Maryland
2020-05-02,ME,1152,19546,20698,23,Maine
2020-05-02,MI,48672,188713,237385,26,Michigan
2020-05-02,MN,9071,80609,89680,27,Minnesota
2020-05-02,MO,8154,74590,82744,29,Missouri
2020-05-02,MP,14,934,948,69,Northern Mariana Islands
2020-05-02,MS,7441,67034,74475,28,Mississippi
2020-05-02,MT,455,14180,14635,30,Montana
2020-05-02,NC,11509,127966,139475,37,North Carolina
2020-05-02,ND,1153,30394,31547,38,North Dakota
2020-05-02,NE,4838,24510,29348,31,Nebraska
2020-05-02,NH,2310,22039,24349,33,New Hampshire
2020-05-02,NJ,123717,138595,262312,34,New Jersey
2020-05-02,NM,3513,67605,71118,35,New Mexico
2020-05-02,NV,5311,39076,44387,32,Nevada
2020-05-02,NY,312977,646094,959071,36,New York
2020-05-02,OH,19335,126484,145819,39,Ohio
2020-05-02,OK,3851,59804,63655,40,Oklahoma
2020-05-02,OR,2635,57501,60136,41,Oregon
2020-05-02,PA,48305,187071,235376,42,Pennsylvania
2020-05-02,PR,1757,9313,11070,72,Puerto Rico
2020-05-02,RI,9289,60639,69928,44,Rhode Island
2020-05-02,SC,6489,55127,61616,45,South Carolina
2020-05-02,SD,2588,15503,18091,46,South Dakota
2020-05-02,TN,12661,183615,196276,47,Tennessee
2020-05-02,TX,30522,350126,380648,48,Texas
2020-05-02,UT,4981,112823,117804,49,Utah
2020-05-02,VA,17731,84365,102096,51,Virginia
2020-05-02,VI,66,922,988,78,U.S. Virgin Islands
2020-05-02,VT,896,15232,16128,50,Vermont
2020-05-02,WA,16455,210822,227277,53,Washington
2020-05-02,WI,7660,75570,83230,55,Wisconsin
2020-05-02,WV,1169,47977,49146,54,West Virginia
2020-05-02,WY,566,9463,10029,56,Wyoming
2020-05-01,AK,364,19961,20325,02,Alaska
2020-05-01,AL,7158,84775,91933,01,Alabama
2020-05-01,AR,3321,46355,49676,05,Arkansas
2020-05-01,AS,0,57,57,60,American Samoa
2020-05-01,AZ,7962,66917,74879,04,Arizona
2020-05-01,CA,50442,604543,654985,06,California
2020-05-01,CO,15284,57106,72390,08,Colorado
2020-05-01,CT,28764,71493,100257,09,Connecticut
2020-05-01,DC,4658,16477,21135,11,District of Columbia
2020-05-01,DE,4918,17667,22585,10,Delaware
2020-05-01,FL,34728,367971,402699,12,Florida
2020-05-01,GA,27270,141097,168367,13,Georgia
2020-05-01,GU,146,2859,3005,66,Guam
2020-05-01,HI,618,30476,31094,15,Hawaii
2020-05-01,IA,7884,37708,45592,19,Iowa
2020-05-01,ID,2015,27210,29225,16,Idaho
2020-05-01,IL,56055,228633,284688,17,Illinois
2020-05-01,IN,18630,81009,99639,18,Indiana
2020-05-01,KS,4449,28585,33034,20,Kansas
2020-05-01,KY,4708,51904,56612,21,Kentucky
2020-05-01,LA,28711,139540,168251,22,Louisiana
2020-05-01,MA,64311,225325,289636,25,Massachusetts
2020-05-01,MD,23472,97511,120983,24,Maryland
2020-05-01,ME,1123,19546,20669,23,Maine
2020-05-01,MI,48240,178807,227047,26,Michigan
2020-05-01,MN,8736,77214,85950,27,Minnesota
2020-05-01,MO,7835,74590,82425,29,Missouri
2020-05-01,MP,14,749,763,69,Northern Mariana Islands
2020-05-01,MS,7212,64336,71548,28,Mississippi
2020-05-01,MT,453,13750,14203,30,Montana
2020-05-01,NC,10923,122909,133832,37,North Carolina
2020-05-01,ND,1107,28418,29525,38,North Dakota
2020-05-01,NE,4281,23104,27385,31,Nebraska
2020-05-01,NH,2146,19903,22049,33,New Hampshire
2020-05-01,NJ,121190,135355,256545,34,New Jersey
2020-05-01,NM,3411,64458,67869,35,New Mexico
2020-05-01,NV,5227,38368,43595,32,Nevada
2020-05-01,NY,308314,619124,927438,36,New York
2020-05-01,OH,18743,121763,140506,39,Ohio
2020-05-01,OK,3748,59804,63552,40,Oklahoma
2020-05-01,OR,2579,55597,58176,41,Oregon
2020-05-01,PA,46971,180477,227448,42,Pennsylvania
2020-05-01,PR,1575,9313,10888,72,Puerto Rico
2020-05-01,RI,8962,57686,66648,44,Rhode Island
2020-05-01,SC,6258,53121,59379,45,South Carolina
2020-05-01,SD,2525,14838,17363,46,South Dakota
2020-05-01,TN,11891,174241,186132,47,Tennessee
2020-05-01,TX,29229,322546,351775,48,Texas
2020-05-01,UT,4828,107730,112558,49,Utah
2020-05-01,VA,16901,89539,106440,51,Virginia
2020-05-01,VI,66,811,877,78,U.S. Virgin Islands
2020-05-01,VT,885,14930,15815,50,Vermont
2020-05-01,WA,16307,208210,224517,53,Washington
2020-05-01,WI,7314,72566,79880,55,Wisconsin
2020-05-01,WV,1136,45708,46844,54,West Virginia
2020-05-01,WY,559,9136,9695,56,Wyoming
2020-04-30,AK,355,18764,19119,02,Alaska
2020-04-30,AL,7019,80177,87196,01,Alabama
2020-04-30,AR,3255,45124,48379,05,Arkansas
2020-04-30,AS,0,3,3,60,American Samoa
2020-04-30,AZ,7648,64138,71786,04,Arizona
2020-04-30,CA,48917,576420,625337,06,California
2020-04-30,CO,14758,56301,71059,08,Colorado
2020-04-30,CT,27700,69433,97133,09,Connecticut
2020-04-30,DC,4323,15756,20079,11,District of Columbia
2020-04-30,DE,4734,17086,21820,10,Delaware
2020-04-30,FL,33690,348715,382405,12,Florida
2020-04-30,GA,26155,122889,149044,13,Georgia
2020-04-30,GU,146,1962,2108,66,Guam
2020-04-30,HI,613,30027,30640,15,Hawaii
2020-04-30,IA,7145,35522,42667,19,Iowa
2020-04-30,ID,1984,26862,28846,16,Idaho
2020-04-30,IL,52918,216949,269867,17,Illinois
2020-04-30,IN,17835,77163,94998,18,Indiana
2020-04-30,KS,4238,27388,31626,20,Kansas
2020-04-30,KY,4539,49562,54101,21,Kentucky
2020-04-30,LA,28001,133308,161309,22,Louisiana
2020-04-30,MA,62205,213442,275647,25,Massachusetts
2020-04-30,MD,21742,92617,114359,24,Maryland
2020-04-30,ME,1095,19546,20641,23,Maine
2020-04-30,MI,47505,168944,216449,26,Michigan
2020-04-30,MN,8116,73349,81465,27,Minnesota
2020-04-30,MO,7562,73125,80687,29,Missouri
2020-04-30,MP,14,585,599,69,Northern Mariana Islands
2020-04-30,MS,6815,59525,66340,28,Mississippi
2020-04-30,MT,453,13461,13914,30,Montana
2020-04-30,NC,10509,117527,128036,37,North Carolina
2020-04-30,ND,1067,26393,27460,38,North Dakota
2020-04-30,NE,3784,21537,25321,31,Nebraska
2020-04-30,NH,2054,19867,21921,33,New Hampshire
2020-04-30,NJ,118652,129266,247918,34,New Jersey
2020-04-30,NM,3213,61872,65085,35,New Mexico
2020-04-30,NV,4998,36988,41986,32,Nevada
2020-04-30,NY,304372,596264,900636,36,New York
2020-04-30,OH,18027,115863,133890,39,Ohio
2020-04-30,OK,3618,59804,63422,40,Oklahoma
2020-04-30,OR,2510,53522,56032,41,Oregon
2020-04-30,PA,45763,175602,221365,42,Pennsylvania
2020-04-30,PR,1539,9313,10852,72,Puerto Rico
2020-04-30,RI,8621,55089,63710,44,Rhode Island
2020-04-30,SC,6095,50417,56512,45,South Carolina
2020-04-30,SD,2449,14579,17028,46,South Dakota
2020-04-30,TN,10735,166891,177626,47,Tennessee
2020-04-30,TX,28087,302213,330300,48,Texas
2020-04-30,UT,4672,103829,108501,49,Utah
2020-04-30,VA,15846,75663,91509,51,Virginia
2020-04-30,VI,66,807,873,78,U.S. Virgin Islands
2020-04-30,VT,879,14357,15236,50,Vermont
2020-04-30,WA,15962,201776,217738,53,Washington
2020-04-30,WI,6854,69394,76248,55,Wisconsin
2020-04-30,WV,1118,43423,44541,54,West Virginia
2020-04-30,WY,544,8902,9446,56,Wyoming
2020-04-29,AK,355,18764,19119,02,Alaska
2020-04-29,AL,6842,73607,80449,01,Alabama
2020-04-29,AR,3192,42257,45449,05,Arkansas
2020-04-29,AS,0,3,3,60,American Samoa
2020-04-29,AZ,7202,61611,68813,04,Arizona
2020-04-29,CA,46500,556639,603139,06,California
2020-04-29,CO,14735,54714,69449,08,Colorado
2020-04-29,CT,26767,68051,94818,09,Connecticut
2020-04-29,DC,4106,15123,19229,11,District of Columbia
2020-04-29,DE,4655,16883,21538,10,Delaware
2020-04-29,FL,33193,340295,373488,12,Florida
2020-04-29,GA,25572,118367,143939,13,Georgia
2020-04-29,GU,145,1702,1847,66,Guam
2020-04-29,HI,609,29009,29618,15,Hawaii
2020-04-29,IA,6843,34494,41337,19,Iowa
2020-04-29,ID,1952,26430,28382,16,Idaho
2020-04-29,IL,50355,206312,256667,17,Illinois
2020-04-29,IN,17182,74368,91550,18,Indiana
2020-04-29,KS,3738,25720,29458,20,Kansas
2020-04-29,KY,4375,48036,52411,21,Kentucky
2020-04-29,LA,27660,128908,156568,22,Louisiana
2020-04-29,MA,60265,205353,265618,25,Massachusetts
2020-04-29,MD,20849,90080,110929,24,Maryland
2020-04-29,ME,1056,19546,20602,23,Maine
2020-04-29,MI,46488,158373,204861,26,Michigan
2020-04-29,MN,7468,69650,77118,27,Minnesota
2020-04-29,MO,7425,69734,77159,29,Missouri
2020-04-29,MP,14,210,224,69,Northern Mariana Islands
2020-04-29,MS,6569,59525,66094,28,Mississippi
2020-04-29,MT,451,13077,13528,30,Montana
2020-04-29,NC,9948,108492,118440,37,North Carolina
2020-04-29,ND,1033,24503,25536,38,North Dakota
2020-04-29,NE,3374,20257,23631,31,Nebraska
2020-04-29,NH,2010,18736,20746,33,New Hampshire
2020-04-29,NJ,116264,125054,241318,34,New Jersey
2020-04-29,NM,2974,58771,61745,35,New Mexico
2020-04-29,NV,4898,36130,41028,32,Nevada
2020-04-29,NY,299691,572790,872481,36,New York
2020-04-29,OH,17303,111605,128908,39,Ohio
2020-04-29,OK,3473,57794,61267,40,Oklahoma
2020-04-29,OR,2446,52026,54472,41,Oregon
2020-04-29,PA,44366,170517,214883,42,Pennsylvania
2020-04-29,PR,1433,9313,10746,72,Puerto Rico
2020-04-29,RI,8247,51918,60165,44,Rhode Island
2020-04-29,SC,5881,48336,54217,45,South Carolina
2020-04-29,SD,2373,14460,16833,46,South Dakota
2020-04-29,TN,10366,158183,168549,47,Tennessee
2020-04-29,TX,27054,287736,314790,48,Texas
2020-04-29,UT,4495,101283,105778,49,Utah
2020-04-29,VA,14961,70979,85940,51,Virginia
2020-04-29,VI,62,732,794,78,U.S. Virgin Islands
2020-04-29,VT,866,14155,15021,50,Vermont
2020-04-29,WA,15701,195541,211242,53,Washington
2020-04-29,WI,6520,66630,73150,55,Wisconsin
2020-04-29,WV,1095,41976,43071,54,West Virginia
2020-04-29,WY,536,8681,9217,56,Wyoming
2020-04-28,AK,351,16738,17089,02,Alaska
2020-04-28,AL,6687,69140,75827,01,Alabama
2020-04-28,AR,3111,37560,40671,05,Arkansas
2020-04-28,AS,0,3,3,60,American Samoa
2020-04-28,AZ,6948,60490,67438,04,Arizona
2020-04-28,CA,45031,532577,577608,06,California
2020-04-28,CO,13879,52462,66341,08,Colorado
2020-04-28,CT,26312,66433,92745,09,Connecticut
2020-04-28,DC,3994,14891,18885,11,District of Columbia
2020-04-28,DE,4575,16605,21180,10,Delaware
2020-04-28,FL,32846,334029,366875,12,Florida
2020-04-28,GA,24615,115405,140020,13,Georgia
2020-04-28,GU,145,1538,1683,66,Guam
2020-04-28,HI,607,28576,29183,15,Hawaii
2020-04-28,IA,6376,33447,39823,19,Iowa
2020-04-28,ID,1917,18135,20052,16,Idaho
2020-04-28,IL,48102,194087,242189,17,Illinois
2020-04-28,IN,16588,70593,87181,18,Indiana
2020-04-28,KS,3491,24599,28090,20,Kansas
2020-04-28,KY,4146,44653,48799,21,Kentucky
2020-04-28,LA,27286,123822,151108,22,Louisiana
2020-04-28,MA,58302,196198,254500,25,Massachusetts
2020-04-28,MD,20113,87672,107785,24,Maryland
2020-04-28,ME,1040,16784,17824,23,Maine
2020-04-28,MI,45538,148910,194448,26,Michigan
2020-04-28,MN,6788,63248,70036,27,Minnesota
2020-04-28,MO,7303,66200,73503,29,Missouri
2020-04-28,MP,14,51,65,69,Northern Mariana Islands
2020-04-28,MS,6342,58070,64412,28,Mississippi
2020-04-28,MT,451,12740,13191,30,Montana
2020-04-28,NC,9568,103184,112752,37,North Carolina
2020-04-28,ND,991,22732,23723,38,North Dakota
2020-04-28,NE,3358,20247,23605,31,Nebraska
2020-04-28,NH,1938,18207,20145,33,New Hampshire
2020-04-28,NJ,113856,120503,234359,34,New Jersey
2020-04-28,NM,2823,55980,58803,35,New Mexico
2020-04-28,NV,4805,35314,40119,32,Nevada
2020-04-28,NY,295106,549888,844994,36,New York
2020-04-28,OH,16128,106578,122706,39,Ohio
2020-04-28,OK,3410,56289,59699,40,Oklahoma
2020-04-28,OR,2354,48844,51198,41,Oregon
2020-04-28,PA,43264,165824,209088,42,Pennsylvania
2020-04-28,PR,1400,9313,10713,72,Puerto Rico
2020-04-28,RI,7926,49767,57693,44,Rhode Island
2020-04-28,SC,5613,46532,52145,45,South Carolina
2020-04-28,SD,2313,14299,16612,46,South Dakota
2020-04-28,TN,10052,151876,161928,47,Tennessee
2020-04-28,TX,26171,274213,300384,48,Texas
2020-04-28,UT,4343,98096,102439,49,Utah
2020-04-28,VA,14339,68959,83298,51,Virginia
2020-04-28,VI,59,719,778,78,U.S. Virgin Islands
2020-04-28,VT,862,13947,14809,50,Vermont
2020-04-28,WA,15459,188973,204432,53,Washington
2020-04-28,WI,6289,63535,69824,55,Wisconsin
2020-04-28,WV,1079,41976,43055,54,West Virginia
2020-04-28,WY,389,8226,8615,56,Wyoming
2020-04-27,AK,345,15911,16256,02,Alaska
2020-04-27,AL,6499,67498,73997,01,Alabama
2020-04-27,AR,3017,37440,40457,05,Arkansas
2020-04-27,AS,0,3,3,60,American Samoa
2020-04-27,AZ,6716,59827,66543,04,Arizona
2020-04-27,CA,43464,509945,553409,06,California
2020-04-27,CO,13441,49833,63274,08,Colorado
2020-04-27,CT,25269,54542,79811,09,Connecticut
2020-04-27,DC,3892,14524,18416,11,District of Columbia
2020-04-27,DE,4162,15454,19616,10,Delaware
2020-04-27,FL,32138,324325,356463,12,Florida
2020-04-27,GA,23913,103256,127169,13,Georgia
2020-04-27,GU,144,1424,1568,66,Guam
2020-04-27,HI,606,28404,29010,15,Hawaii
2020-04-27,IA,5868,32282,38150,19,Iowa
2020-04-27,ID,1897,18127,20024,16,Idaho
2020-04-27,IL,45883,181745,227628,17,Illinois
2020-04-27,IN,15961,68515,84476,18,Indiana
2020-04-27,KS,3328,23839,27167,20,Kansas
2020-04-27,KY,4074,44400,48474,21,Kentucky
2020-04-27,LA,27068,119921,146989,22,Louisiana
2020-04-27,MA,56462,188425,244887,25,Massachusetts
2020-04-27,MD,19487,85489,104976,24,Maryland
2020-04-27,ME,1023,16784,17807,23,Maine
2020-04-27,MI,44709,140972,185681,26,Michigan
2020-04-27,MN,6187,60503,66690,27,Minnesota
2020-04-27,MO,7171,63935,71106,29,Missouri
2020-04-27,MP,14,51,65,69,Northern Mariana Islands
2020-04-27,MS,6094,57368,63462,28,Mississippi
2020-04-27,MT,449,12584,13033,30,Montana
2020-04-27,NC,9142,100778,109920,37,North Carolina
2020-04-27,ND,942,21492,22434,38,North Dakota
2020-04-27,NE,3028,19335,22363,31,Nebraska
2020-04-27,NH,1864,17860,19724,33,New Hampshire
2020-04-27,NJ,111188,116587,227775,34,New Jersey
2020-04-27,NM,2726,53889,56615,35,New Mexico
2020-04-27,NV,4690,34123,38813,32,Nevada
2020-04-27,NY,291996,534099,826095,36,New York
2020-04-27,OH,15699,103692,119391,39,Ohio
2020-04-27,OK,3280,49891,53171,40,Oklahoma
2020-04-27,OR,2354,48844,51198,41,Oregon
2020-04-27,PA,42050,161372,203422,42,Pennsylvania
2020-04-27,PR,1389,9313,10702,72,Puerto Rico
2020-04-27,RI,7708,48177,55885,44,Rhode Island
2020-04-27,SC,5490,45271,50761,45,South Carolina
2020-04-27,SD,2245,14130,16375,46,South Dakota
2020-04-27,TN,9918,144484,154402,47,Tennessee
2020-04-27,TX,25297,265220,290517,48,Texas
2020-04-27,UT,4233,95962,100195,49,Utah
2020-04-27,VA,13535,67144,80679,51,Virginia
2020-04-27,VI,59,716,775,78,U.S. Virgin Islands
2020-04-27,VT,862,13819,14681,50,Vermont
2020-04-27,WA,15225,182278,197503,53,Washington
2020-04-27,WI,6081,61311,67392,55,Wisconsin
2020-04-27,WV,1063,41976,43039,54,West Virginia
2020-04-27,WY,370,7797,8167,56,Wyoming
2020-04-26,AK,341,15836,16177,02,Alaska
2020-04-26,AL,6270,67281,73551,01,Alabama
2020-04-26,AR,2941,36528,39469,05,Arkansas
2020-04-26,AS,0,3,3,60,American Samoa
2020-04-26,AZ,6526,58285,64811,04,Arizona
2020-04-26,CA,42164,483920,526084,06,California
2020-04-26,CO,12968,46823,59791,08,Colorado
2020-04-26,CT,25269,54542,79811,09,Connecticut
2020-04-26,DC,3841,14227,18068,11,District of Columbia
2020-04-26,DE,4034,15215,19249,10,Delaware
2020-04-26,FL,31528,313085,344613,12,Florida
2020-04-26,GA,23401,99822,123223,13,Georgia
2020-04-26,GU,141,1387,1528,66,Guam
2020-04-26,HI,603,27880,28483,15,Hawaii
2020-04-26,IA,5476,30614,36090,19,Iowa
2020-04-26,ID,1887,17611,19498,16,Idaho
2020-04-26,IL,43903,171049,214952,17,Illinois
2020-04-26,IN,15012,66696,81708,18,Indiana
2020-04-26,KS,3174,23053,26227,20,Kansas
2020-04-26,KY,3905,42653,46558,21,Kentucky
2020-04-26,LA,26773,116263,143036,22,Louisiana
2020-04-26,MA,54938,181162,236100,25,Massachusetts
2020-04-26,MD,18581,78084,96665,24,Maryland
2020-04-26,ME,1015,16784,17799,23,Maine
2020-04-26,MI,43789,134431,178220,26,Michigan
2020-04-26,MN,5512,59161,64673,27,Minnesota
2020-04-26,MO,6997,62751,69748,29,Missouri
2020-04-26,MP,14,51,65,69,Northern Mariana Islands
2020-04-26,MS,5911,54877,60788,28,Mississippi
2020-04-26,MT,448,12414,12862,30,Montana
2020-04-26,NC,8830,99064,107894,37,North Carolina
2020-04-26,ND,867,19850,20717,38,North Dakota
2020-04-26,NE,2732,18496,21228,31,Nebraska
2020-04-26,NH,1787,16964,18751,33,New Hampshire
2020-04-26,NJ,109038,114106,223144,34,New Jersey
2020-04-26,NM,2660,51075,53735,35,New Mexico
2020-04-26,NV,4602,33584,38186,32,Nevada
2020-04-26,NY,288045,517305,805350,36,New York
2020-04-26,OH,15963,100423,116386,39,Ohio
2020-04-26,OK,3253,49891,53144,40,Oklahoma
2020-04-26,OR,2311,46653,48964,41,Oregon
2020-04-26,PA,41165,157428,198593,42,Pennsylvania
2020-04-26,PR,1371,9313,10684,72,Puerto Rico
2020-04-26,RI,7439,45964,53403,44,Rhode Island
2020-04-26,SC,5490,45271,50761,45,South Carolina
2020-04-26,SD,2212,14062,16274,46,South Dakota
2020-04-26,TN,9667,137807,147474,47,Tennessee
2020-04-26,TX,24631,251390,276021,48,Texas
2020-04-26,UT,4123,91579,95702,49,Utah
2020-04-26,VA,12970,63630,76600,51,Virginia
2020-04-26,VI,57,700,757,78,U.S. Virgin Islands
2020-04-26,VT,855,13518,14373,50,Vermont
2020-04-26,WA,14952,175256,190208,53,Washington
2020-04-26,WI,5911,59235,65146,55,Wisconsin
2020-04-26,WV,1044,38019,39063,54,West Virginia
2020-04-26,WY,362,7797,8159,56,Wyoming
2020-04-25,AK,339,15393,15732,02,Alaska
2020-04-25,AL,6137,65207,71344,01,Alabama
2020-04-25,AR,2829,35224,38053,05,Arkansas
2020-04-25,AS,0,3,3,60,American Samoa
2020-04-25,AZ,6280,56228,62508,04,Arizona
2020-04-25,CA,41137,464898,506035,06,California
2020-04-25,CO,12256,44533,56789,08,Colorado
2020-04-25,CT,24582,53020,77602,09,Connecticut
2020-04-25,DC,3699,13603,17302,11,District of Columbia
2020-04-25,DE,3576,14122,17698,10,Delaware
2020-04-25,FL,30839,302260,333099,12,Florida
2020-04-25,GA,22695,96319,119014,13,Georgia
2020-04-25,GU,141,1308,1449,66,Guam
2020-04-25,HI,601,27439,28040,15,Hawaii
2020-04-25,IA,5092,29258,34350,19,Iowa
2020-04-25,ID,1870,17611,19481,16,Idaho
2020-04-25,IL,41777,159840,201617,17,Illinois
2020-04-25,IN,14395,65379,79774,18,Indiana
2020-04-25,KS,3056,22143,25199,20,Kansas
2020-04-25,KY,3779,41183,44962,21,Kentucky
2020-04-25,LA,26512,112490,139002,22,Louisiana
2020-04-25,MA,53348,173497,226845,25,Massachusetts
2020-04-25,MD,17766,71357,89123,24,Maryland
2020-04-25,ME,990,16784,17774,23,Maine
2020-04-25,MI,43263,128955,172218,26,Michigan
2020-04-25,MN,5127,56982,62109,27,Minnesota
2020-04-25,MO,6826,60392,67218,29,Missouri
2020-04-25,MP,14,51,65,69,Northern Mariana Islands
2020-04-25,MS,5718,53239,58957,28,Mississippi
2020-04-25,MT,445,12052,12497,30,Montana
2020-04-25,NC,8623,96642,105265,37,North Carolina
2020-04-25,ND,803,18547,19350,38,North Dakota
2020-04-25,NE,2421,17552,19973,31,Nebraska
2020-04-25,NH,1720,16007,17727,33,New Hampshire
2020-04-25,NJ,105523,108163,213686,34,New Jersey
2020-04-25,NM,2521,48989,51510,35,New Mexico
2020-04-25,NV,4539,32669,37208,32,Nevada
2020-04-25,NY,282143,495425,777568,36,New York
2020-04-25,OH,15587,96396,111983,39,Ohio
2020-04-25,OK,3193,49891,53084,40,Oklahoma
2020-04-25,OR,2253,45124,47377,41,Oregon
2020-04-25,PA,40049,152886,192935,42,Pennsylvania
2020-04-25,PR,1307,9313,10620,72,Puerto Rico
2020-04-25,RI,7129,43762,50891,44,Rhode Island
2020-04-25,SC,5253,43761,49014,45,South Carolina
2020-04-25,SD,2147,13449,15596,46,South Dakota
2020-04-25,TN,9189,132217,141406,47,Tennessee
2020-04-25,TX,23773,239043,262816,48,Texas
2020-04-25,UT,3948,86258,90206,49,Utah
2020-04-25,VA,12366,60276,72642,51,Virginia
2020-04-25,VI,55,693,748,78,U.S. Virgin Islands
2020-04-25,VT,852,13270,14122,50,Vermont
2020-04-25,WA,14773,173679,188452,53,Washington
2020-04-25,WI,5687,57138,62825,55,Wisconsin
2020-04-25,WV,1020,31946,32966,54,West Virginia
2020-04-25,WY,349,7797,8146,56,Wyoming
2020-04-24,AK,339,11942,12281,02,Alaska
2020-04-24,AL,5832,46863,52695,01,Alabama
2020-04-24,AR,2741,32837,35578,05,Arkansas
2020-04-24,AS,0,3,3,60,American Samoa
2020-04-24,AZ,6045,54669,60714,04,Arizona
2020-04-24,CA,39254,454919,494173,06,California
2020-04-24,CO,11262,41062,52324,08,Colorado
2020-04-24,CT,23921,50117,74038,09,Connecticut
2020-04-24,DC,3528,13005,16533,11,District of Columbia
2020-04-24,DE,3442,13937,17379,10,Delaware
2020-04-24,FL,30174,286785,316959,12,Florida
2020-04-24,GA,22147,85029,107176,13,Georgia
2020-04-24,GU,141,1233,1374,66,Guam
2020-04-24,HI,596,26291,26887,15,Hawaii
2020-04-24,IA,4445,27528,31973,19,Iowa
2020-04-24,ID,1836,17611,19447,16,Idaho
2020-04-24,IL,39658,149974,189632,17,Illinois
2020-04-24,IN,13680,61873,75553,18,Indiana
2020-04-24,KS,2777,20811,23588,20,Kansas
2020-04-24,KY,3481,39363,42844,21,Kentucky
2020-04-24,LA,26140,111972,138112,22,Louisiana
2020-04-24,MA,50969,164244,215213,25,Massachusetts
2020-04-24,MD,16616,68100,84716,24,Maryland
2020-04-24,ME,965,16784,17749,23,Maine
2020-04-24,MI,42730,123054,165784,26,Michigan
2020-04-24,MN,4788,54706,59494,27,Minnesota
2020-04-24,MO,6625,58582,65207,29,Missouri
2020-04-24,MP,14,51,65,69,Northern Mariana Islands
2020-04-24,MS,5434,50236,55670,28,Mississippi
2020-04-24,MT,444,11683,12127,30,Montana
2020-04-24,NC,8052,92532,100584,37,North Carolina
2020-04-24,ND,748,16701,17449,38,North Dakota
2020-04-24,NE,2124,16488,18612,31,Nebraska
2020-04-24,NH,1670,15139,16809,33,New Hampshire
2020-04-24,NJ,102196,103766,205962,34,New Jersey
2020-04-24,NM,2379,44184,46563,35,New Mexico
2020-04-24,NV,4398,31794,36192,32,Nevada
2020-04-24,NY,271590,459066,730656,36,New York
2020-04-24,OH,15169,92528,107697,39,Ohio
2020-04-24,OK,3121,43019,46140,40,Oklahoma
2020-04-24,OR,2177,43315,45492,41,Oregon
2020-04-24,PA,38652,147491,186143,42,Pennsylvania
2020-04-24,PR,1276,9313,10589,72,Puerto Rico
2020-04-24,RI,6699,40558,47257,44,Rhode Island
2020-04-24,SC,4917,39546,44463,45,South Carolina
2020-04-24,SD,2040,12784,14824,46,South Dakota
2020-04-24,TN,8726,122602,131328,47,Tennessee
2020-04-24,TX,22806,219741,242547,48,Texas
2020-04-24,UT,3782,80915,84697,49,Utah
2020-04-24,VA,11594,57846,69440,51,Virginia
2020-04-24,VI,54,642,696,78,U.S. Virgin Islands
2020-04-24,VT,843,12808,13651,50,Vermont
2020-04-24,WA,14581,170421,185002,53,Washington
2020-04-24,WI,5356,54573,59929,55,Wisconsin
2020-04-24,WV,988,28823,29811,54,West Virginia
2020-04-24,WY,349,7696,8045,56,Wyoming
2020-04-23,AK,337,11824,12161,02,Alaska
2020-04-23,AL,5778,46863,52641,01,Alabama
2020-04-23,AR,2465,29125,31590,05,Arkansas
2020-04-23,AS,0,3,3,60,American Samoa
2020-04-23,AZ,5769,52928,58697,04,Arizona
2020-04-23,CA,37369,444728,482097,06,California
2020-04-23,CO,10878,39767,50645,08,Colorado
2020-04-23,CT,23100,48397,71497,09,Connecticut
2020-04-23,DC,3361,12569,15930,11,District of Columbia
2020-04-23,DE,3308,13604,16912,10,Delaware
2020-04-23,FL,28832,267876,296708,12,Florida
2020-04-23,GA,21512,79550,101062,13,Georgia
2020-04-23,GU,135,1180,1315,66,Guam
2020-04-23,HI,592,25536,26128,15,Hawaii
2020-04-23,IA,3924,25338,29262,19,Iowa
2020-04-23,ID,1802,17370,19172,16,Idaho
2020-04-23,IL,36934,136382,173316,17,Illinois
2020-04-23,IN,13039,59001,72040,18,Indiana
2020-04-23,KS,2482,18836,21318,20,Kansas
2020-04-23,KY,3373,32702,36075,21,Kentucky
2020-04-23,LA,25739,111774,137513,22,Louisiana
2020-04-23,MA,47992,156324,204316,25,Massachusetts
2020-04-23,MD,15737,64363,80100,24,Maryland
2020-04-23,ME,937,16784,17721,23,Maine
2020-04-23,MI,41694,115005,156699,26,Michigan
2020-04-23,MN,4270,52144,56414,27,Minnesota
2020-04-23,MO,6321,53129,59450,29,Missouri
2020-04-23,MP,14,51,65,69,Northern Mariana Islands
2020-04-23,MS,5153,50236,55389,28,Mississippi
2020-04-23,MT,442,11433,11875,30,Montana
2020-04-23,NC,7608,88577,96185,37,North Carolina
2020-04-23,ND,709,15621,16330,38,North Dakota
2020-04-23,NE,1813,15547,17360,31,Nebraska
2020-04-23,NH,1588,14424,16012,33,New Hampshire
2020-04-23,NJ,99989,100159,200148,34,New Jersey
2020-04-23,NM,2210,39022,41232,35,New Mexico
2020-04-23,NV,4208,30541,34749,32,Nevada
2020-04-23,NY,263460,432460,695920,36,New York
2020-04-23,OH,14694,88183,102877,39,Ohio
2020-04-23,OK,3017,43019,46036,40,Oklahoma
2020-04-23,OR,2127,41849,43976,41,Oregon
2020-04-23,PA,37053,142061,179114,42,Pennsylvania
2020-04-23,PR,915,9313,10228,72,Puerto Rico
2020-04-23,RI,6262,38163,44425,44,Rhode Island
2020-04-23,SC,4917,39546,44463,45,South Carolina
2020-04-23,SD,1956,12109,14065,46,South Dakota
2020-04-23,TN,8266,114834,123100,47,Tennessee
2020-04-23,TX,21944,203134,225078,48,Texas
2020-04-23,UT,3612,77015,80627,49,Utah
2020-04-23,VA,10998,53891,64889,51,Virginia
2020-04-23,VI,54,583,637,78,U.S. Virgin Islands
2020-04-23,VT,834,12420,13254,50,Vermont
2020-04-23,WA,14294,163706,178000,53,Washington
2020-04-23,WI,5052,51456,56508,55,Wisconsin
2020-04-23,WV,967,26938,27905,54,West Virginia
2020-04-23,WY,326,7241,7567,56,Wyoming
2020-04-22,AK,335,11824,12159,02,Alaska
2020-04-22,AL,5465,43295,48760,01,Alabama
2020-04-22,AR,2276,27437,29713,05,Arkansas
2020-04-22,AS,0,3,3,60,American Samoa
2020-04-22,AZ,5459,51142,56601,04,Arizona
2020-04-22,CA,35396,429931,465327,06,California
2020-04-22,CO,10447,38257,48704,08,Colorado
2020-04-22,CT,22469,47449,69918,09,Connecticut
2020-04-22,DC,3206,12296,15502,11,District of Columbia
2020-04-22,DE,3200,13353,16553,10,Delaware
2020-04-22,FL,28309,260318,288627,12,Florida
2020-04-22,GA,20740,73332,94072,13,Georgia
2020-04-22,GU,134,1086,1220,66,Guam
2020-04-22,HI,582,24760,25342,15,Hawaii
2020-04-22,IA,3748,24496,28244,19,Iowa
2020-04-22,ID,1766,16404,18170,16,Idaho
2020-04-22,IL,35108,129238,164346,17,Illinois
2020-04-22,IN,12438,57032,69470,18,Indiana
2020-04-22,KS,2211,17992,20203,20,Kansas
2020-04-22,KY,3192,30136,33328,21,Kentucky
2020-04-22,LA,25258,111588,136846,22,Louisiana
2020-04-22,MA,44913,144789,189702,25,Massachusetts
2020-04-22,MD,14775,61754,76529,24,Maryland
2020-04-22,ME,907,16784,17691,23,Maine
2020-04-22,MI,40705,106653,147358,26,Michigan
2020-04-22,MN,3758,50165,53923,27,Minnesota
2020-04-22,MO,6137,52019,58156,29,Missouri
2020-04-22,MP,14,51,65,69,Northern Mariana Islands
2020-04-22,MS,4894,48941,53835,28,Mississippi
2020-04-22,MT,439,11144,11583,30,Montana
2020-04-22,NC,7220,83116,90336,37,North Carolina
2020-04-22,ND,679,14910,15589,38,North Dakota
2020-04-22,NE,1722,14957,16679,31,Nebraska
2020-04-22,NH,1491,13550,15041,33,New Hampshire
2020-04-22,NJ,95865,95794,191659,34,New Jersey
2020-04-22,NM,2072,38805,40877,35,New Mexico
2020-04-22,NV,4081,29807,33888,32,Nevada
2020-04-22,NY,257216,412766,669982,36,New York
2020-04-22,OH,14117,84389,98506,39,Ohio
2020-04-22,OK,2894,43019,45913,40,Oklahoma
2020-04-22,OR,2059,39126,41185,41,Oregon
2020-04-22,PA,35684,136272,171956,42,Pennsylvania
2020-04-22,PR,915,8842,9757,72,Puerto Rico
2020-04-22,RI,5845,35881,41726,44,Rhode Island
2020-04-22,SC,4761,38350,43111,45,South Carolina
2020-04-22,SD,1858,11588,13446,46,South Dakota
2020-04-22,TN,7842,107138,114980,47,Tennessee
2020-04-22,TX,21069,195714,216783,48,Texas
2020-04-22,UT,3445,73015,76460,49,Utah
2020-04-22,VA,10266,50512,60778,51,Virginia
2020-04-22,VI,54,583,637,78,U.S. Virgin Islands
2020-04-22,VT,831,12097,12928,50,Vermont
2020-04-22,WA,14040,158437,172477,53,Washington
2020-04-22,WI,4845,49502,54347,55,Wisconsin
2020-04-22,WV,939,24897,25836,54,West Virginia
2020-04-22,WY,322,7301,7623,56,Wyoming
2020-04-21,AK,329,10790,11119,02,Alaska
2020-04-21,AL,5231,43295,48526,01,Alabama
2020-04-21,AR,2227,25214,27441,05,Arkansas
2020-04-21,AS,0,3,3,60,American Samoa
2020-04-21,AZ,5251,49901,55152,04,Arizona
2020-04-21,CA,33261,266839,300100,06,California
2020-04-21,CO,10106,37360,47466,08,Colorado
2020-04-21,CT,20360,43832,64192,09,Connecticut
2020-04-21,DC,3098,11841,14939,11,District of Columbia
2020-04-21,DE,2931,12935,15866,10,Delaware
2020-04-21,FL,27495,249564,277059,12,Florida
2020-04-21,GA,19881,68259,88140,13,Georgia
2020-04-21,GU,133,1033,1166,66,Guam
2020-04-21,HI,584,24112,24696,15,Hawaii
2020-04-21,IA,3641,23974,27615,19,Iowa
2020-04-21,ID,1736,16071,17807,16,Idaho
2020-04-21,IL,33059,121938,154997,17,Illinois
2020-04-21,IN,12097,55167,67264,18,Indiana
2020-04-21,KS,2025,17076,19101,20,Kansas
2020-04-21,KY,3050,29770,32820,21,Kentucky
2020-04-21,LA,24854,111588,136442,22,Louisiana
2020-04-21,MA,43168,141444,184612,25,Massachusetts
2020-04-21,MD,14193,59442,73635,24,Maryland
2020-04-21,ME,888,14076,14964,23,Maine
2020-04-21,MI,39589,99667,139256,26,Michigan
2020-04-21,MN,3452,48341,51793,27,Minnesota
2020-04-21,MO,5941,51179,57120,29,Missouri
2020-04-21,MP,14,51,65,69,Northern Mariana Islands
2020-04-21,MS,4716,47648,52364,28,Mississippi
2020-04-21,MT,437,10804,11241,30,Montana
2020-04-21,NC,6951,76380,83331,37,North Carolina
2020-04-21,ND,644,14343,14987,38,North Dakota
2020-04-21,NE,1648,14724,16372,31,Nebraska
2020-04-21,NH,1491,12848,14339,33,New Hampshire
2020-04-21,NJ,92387,92439,184826,34,New Jersey
2020-04-21,NM,1971,36784,38755,35,New Mexico
2020-04-21,NV,3937,29118,33055,32,Nevada
2020-04-21,NY,251690,397635,649325,36,New York
2020-04-21,OH,13725,80989,94714,39,Ohio
2020-04-21,OK,2807,41537,44344,40,Oklahoma
2020-04-21,OR,2002,39126,41128,41,Oregon
2020-04-21,PA,34528,132323,166851,42,Pennsylvania
2020-04-21,PR,1298,8789,10087,72,Puerto Rico
2020-04-21,RI,5467,33833,39300,44,Rhode Island
2020-04-21,SC,4439,36838,41277,45,South Carolina
2020-04-21,SD,1755,11060,12815,46,South Dakota
2020-04-21,TN,7394,100788,108182,47,Tennessee
2020-04-21,TX,20196,185203,205399,48,Texas
2020-04-21,UT,3296,69062,72358,49,Utah
2020-04-21,VA,9630,48724,58354,51,Virginia
2020-04-21,VI,54,574,628,78,U.S. Virgin Islands
2020-04-21,VT,828,11767,12595,50,Vermont
2020-04-21,WA,13802,153328,167130,53,Washington
2020-04-21,WI,4620,47841,52461,55,Wisconsin
2020-04-21,WV,914,21849,22763,54,West Virginia
2020-04-21,WY,320,7301,7621,56,Wyoming
2020-04-20,AK,321,9803,10124,02,Alaska
2020-04-20,AL,5025,40875,45900,01,Alabama
2020-04-20,AR,1923,24630,26553,05,Arkansas
2020-04-20,AS,0,3,3,60,American Samoa
2020-04-20,AZ,5064,49436,54500,04,Arizona
2020-04-20,CA,30978,259522,290500,06,California
2020-04-20,CO,9730,36465,46195,08,Colorado
2020-04-20,CT,19815,42991,62806,09,Connecticut
2020-04-20,DC,2927,11186,14113,11,District of Columbia
2020-04-20,DE,2745,12508,15253,10,Delaware
2020-04-20,FL,26660,239565,266225,12,Florida
2020-04-20,GA,18947,65381,84328,13,Georgia
2020-04-20,GU,133,991,1124,66,Guam
2020-04-20,HI,580,23595,24175,15,Hawaii
2020-04-20,IA,3159,22661,25820,19,Iowa
2020-04-20,ID,1672,15773,17445,16,Idaho
2020-04-20,IL,31508,116850,148358,17,Illinois
2020-04-20,IN,11686,52953,64639,18,Indiana
2020-04-20,KS,1986,16775,18761,20,Kansas
2020-04-20,KY,2960,29612,32572,21,Kentucky
2020-04-20,LA,24523,111588,136111,22,Louisiana
2020-04-20,MA,41416,136046,177462,25,Massachusetts
2020-04-20,MD,13684,57713,71397,24,Maryland
2020-04-20,ME,875,14076,14951,23,Maine
2020-04-20,MI,38494,93393,131887,26,Michigan
2020-04-20,MN,3190,46854,50044,27,Minnesota
2020-04-20,MO,5807,50206,56013,29,Missouri
2020-04-20,MP,14,51,65,69,Northern Mariana Islands
2020-04-20,MS,4512,46922,51434,28,Mississippi
2020-04-20,MT,433,10618,11051,30,Montana
2020-04-20,NC,6764,72720,79484,37,North Carolina
2020-04-20,ND,627,14120,14747,38,North Dakota
2020-04-20,NE,1474,14206,15680,31,Nebraska
2020-04-20,NH,1392,12726,14118,33,New Hampshire
2020-04-20,NJ,88806,89251,178057,34,New Jersey
2020-04-20,NM,1845,35197,37042,35,New Mexico
2020-04-20,NV,3830,28517,32347,32,Nevada
2020-04-20,NY,247512,386349,633861,36,New York
2020-04-20,OH,12919,77920,90839,39,Ohio
2020-04-20,OK,2680,32966,35646,40,Oklahoma
2020-04-20,OR,1956,38089,40045,41,Oregon
2020-04-20,PA,33232,129720,162952,42,Pennsylvania
2020-04-20,PR,1252,8486,9738,72,Puerto Rico
2020-04-20,RI,5098,31990,37088,44,Rhode Island
2020-04-20,SC,4377,36103,40480,45,South Carolina
2020-04-20,SD,1685,10641,12326,46,South Dakota
2020-04-20,TN,7238,93451,100689,47,Tennessee
2020-04-20,TX,19458,170936,190394,48,Texas
2020-04-20,UT,3213,65098,68311,49,Utah
2020-04-20,VA,8990,47745,56735,51,Virginia
2020-04-20,VI,53,554,607,78,U.S. Virgin Islands
2020-04-20,VT,820,11671,12491,50,Vermont
2020-04-20,WA,13561,148408,161969,53,Washington
2020-04-20,WI,4499,46603,51102,55,Wisconsin
2020-04-20,WV,902,21253,22155,54,West Virginia
2020-04-20,WY,313,7073,7386,56,Wyoming
2020-04-19,AK,319,9576,9895,02,Alaska
2020-04-19,AL,4837,40875,45712,01,Alabama
2020-04-19,AR,1781,22428,24209,05,Arkansas
2020-04-19,AS,0,3,3,60,American Samoa
2020-04-19,AZ,4929,48061,52990,04,Arizona
2020-04-19,CA,30333,250567,280900,06,California
2020-04-19,CO,9433,35173,44606,08,Colorado
2020-04-19,CT,17550,40663,58213,09,Connecticut
2020-04-19,DC,2793,10906,13699,11,District of Columbia
2020-04-19,DE,2538,12256,14794,10,Delaware
2020-04-19,FL,25996,230083,256079,12,Florida
2020-04-19,GA,18301,61632,79933,13,Georgia
2020-04-19,GU,133,943,1076,66,Guam
2020-04-19,HI,574,22896,23470,15,Hawaii
2020-04-19,IA,2902,21648,24550,19,Iowa
2020-04-19,ID,1668,15773,17441,16,Idaho
2020-04-19,IL,30357,112961,143318,17,Illinois
2020-04-19,IN,11210,49932,61142,18,Indiana
2020-04-19,KS,1849,16281,18130,20,Kansas
2020-04-19,KY,2707,29518,32225,21,Kentucky
2020-04-19,LA,23928,111420,135348,22,Louisiana
2020-04-19,MA,39820,129295,169115,25,Massachusetts
2020-04-19,MD,12830,55061,67891,24,Maryland
2020-04-19,ME,867,14076,14943,23,Maine
2020-04-19,MI,37557,89758,127315,26,Michigan
2020-04-19,MN,2914,46288,49202,27,Minnesota
2020-04-19,MO,5667,48242,53909,29,Missouri
2020-04-19,MP,14,42,56,69,Northern Mariana Islands
2020-04-19,MS,4274,34791,39065,28,Mississippi
2020-04-19,MT,433,10465,10898,30,Montana
2020-04-19,NC,6493,72279,78772,37,North Carolina
2020-04-19,ND,585,13045,13630,38,North Dakota
2020-04-19,NE,1287,13288,14575,31,Nebraska
2020-04-19,NH,1342,12082,13424,33,New Hampshire
2020-04-19,NJ,85301,85387,170688,34,New Jersey
2020-04-19,NM,1798,34834,36632,35,New Mexico
2020-04-19,NV,3728,27870,31598,32,Nevada
2020-04-19,NY,242786,374769,617555,36,New York
2020-04-19,OH,11602,75697,87299,39,Ohio
2020-04-19,OK,2599,32966,35565,40,Oklahoma
2020-04-19,OR,1910,37128,39038,41,Oregon
2020-04-19,PA,32284,126570,158854,42,Pennsylvania
2020-04-19,PR,1213,8280,9493,72,Puerto Rico
2020-04-19,RI,4755,29993,34748,44,Rhode Island
2020-04-19,SC,4377,36103,40480,45,South Carolina
2020-04-19,SD,1635,10427,12062,46,South Dakota
2020-04-19,TN,7070,90028,97098,47,Tennessee
2020-04-19,TX,18923,163787,182710,48,Texas
2020-04-19,UT,3069,60486,63555,49,Utah
2020-04-19,VA,8537,46196,54733,51,Virginia
2020-04-19,VI,53,548,601,78,U.S. Virgin Islands
2020-04-19,VT,817,11450,12267,50,Vermont
2020-04-19,WA,13256,143863,157119,53,Washington
2020-04-19,WI,4346,45323,49669,55,Wisconsin
2020-04-19,WV,863,19168,20031,54,West Virginia
2020-04-19,WY,309,6972,7281,56,Wyoming
2020-04-18,AK,314,9341,9655,02,Alaska
2020-04-18,AL,4655,37883,42538,01,Alabama
2020-04-18,AR,1739,22402,24141,05,Arkansas
2020-04-18,AS,0,3,3,60,American Samoa
2020-04-18,AZ,4719,46326,51045,04,Arizona
2020-04-18,CA,28963,230703,259666,06,California
2020-04-18,CO,9047,34260,43307,08,Colorado
2020-04-18,CT,16809,38653,55462,09,Connecticut
2020-04-18,DC,2666,10602,13268,11,District of Columbia
2020-04-18,DE,2323,11694,14017,10,Delaware
2020-04-18,FL,25269,221258,246527,12,Florida
2020-04-18,GA,17669,56539,74208,13,Georgia
2020-04-18,GU,133,943,1076,66,Guam
2020-04-18,HI,553,21790,22343,15,Hawaii
2020-04-18,IA,2513,20434,22947,19,Iowa
2020-04-18,ID,1655,15292,16947,16,Idaho
2020-04-18,IL,29160,108244,137404,17,Illinois
2020-04-18,IN,10641,46232,56873,18,Indiana
2020-04-18,KS,1790,15886,17676,20,Kansas
2020-04-18,KY,2522,28074,30596,21,Kentucky
2020-04-18,LA,23580,114419,137999,22,Louisiana
2020-04-18,MA,37527,124604,162131,25,Massachusetts
2020-04-18,MD,12308,53062,65370,24,Maryland
2020-04-18,ME,847,14076,14923,23,Maine
2020-04-18,MI,37029,87114,124143,26,Michigan
2020-04-18,MN,2788,45182,47970,27,Minnesota
2020-04-18,MO,5517,48242,53759,29,Missouri
2020-04-18,MP,14,42,56,69,Northern Mariana Islands
2020-04-18,MS,3974,34791,38765,28,Mississippi
2020-04-18,MT,426,10143,10569,30,Montana
2020-04-18,NC,6140,70071,76211,37,North Carolina
2020-04-18,ND,528,12435,12963,38,North Dakota
2020-04-18,NE,1138,12539,13677,31,Nebraska
2020-04-18,NH,1287,11565,12852,33,New Hampshire
2020-04-18,NJ,81420,81116,162536,34,New Jersey
2020-04-18,NM,1711,33902,35613,35,New Mexico
2020-04-18,NV,3626,27125,30751,32,Nevada
2020-04-18,NY,236732,359800,596532,36,New York
2020-04-18,OH,10222,68819,79041,39,Ohio
2020-04-18,OK,2570,32966,35536,40,Oklahoma
2020-04-18,OR,1844,35739,37583,41,Oregon
2020-04-18,PA,31069,122896,153965,42,Pennsylvania
2020-04-18,PR,1118,8055,9173,72,Puerto Rico
2020-04-18,RI,4479,28335,32814,44,Rhode Island
2020-04-18,SC,4246,34587,38833,45,South Carolina
2020-04-18,SD,1542,10118,11660,46,South Dakota
2020-04-18,TN,6762,83824,90586,47,Tennessee
2020-04-18,TX,18260,157979,176239,48,Texas
2020-04-18,UT,2931,57013,59944,49,Utah
2020-04-18,VA,8053,43878,51931,51,Virginia
2020-04-18,VI,53,390,443,78,U.S. Virgin Islands
2020-04-18,VT,813,11212,12025,50,Vermont
2020-04-18,WA,13082,142420,155502,53,Washington
2020-04-18,WI,4199,43962,48161,55,Wisconsin
2020-04-18,WV,785,18655,19440,54,West Virginia
2020-04-18,WY,305,6217,6522,56,Wyoming
2020-04-17,AK,309,9141,9450,02,Alaska
2020-04-17,AL,4530,33318,37848,01,Alabama
2020-04-17,AR,1695,21799,23494,05,Arkansas
2020-04-17,AS,0,3,3,60,American Samoa
2020-04-17,AZ,4507,44723,49230,04,Arizona
2020-04-17,CA,27528,224086,251614,06,California
2020-04-17,CO,8675,33155,41830,08,Colorado
2020-04-17,CT,16809,38653,55462,09,Connecticut
2020-04-17,DC,2476,10167,12643,11,District of Columbia
2020-04-17,DE,2323,11694,14017,10,Delaware
2020-04-17,FL,24119,210718,234837,12,Florida
2020-04-17,GA,17194,54490,71684,13,Georgia
2020-04-17,GU,133,940,1073,66,Guam
2020-04-17,HI,541,21316,21857,15,Hawaii
2020-04-17,IA,2332,19460,21792,19,Iowa
2020-04-17,ID,1609,15043,16652,16,Idaho
2020-04-17,IL,27575,102588,130163,17,Illinois
2020-04-17,IN,10154,44631,54785,18,Indiana
2020-04-17,KS,1705,15196,16901,20,Kansas
2020-04-17,KY,2429,27318,29747,21,Kentucky
2020-04-17,LA,23118,108869,131987,22,Louisiana
2020-04-17,MA,35125,117195,152320,25,Massachusetts
2020-04-17,MD,11572,50437,62009,24,Maryland
2020-04-17,ME,827,14076,14903,23,Maine
2020-04-17,MI,36320,83268,119588,26,Michigan
2020-04-17,MN,2668,43820,46488,27,Minnesota
2020-04-17,MO,5283,46434,51717,29,Missouri
2020-04-17,MP,13,42,55,69,Northern Mariana Islands
2020-04-17,MS,3793,34791,38584,28,Mississippi
2020-04-17,MT,422,9822,10244,30,Montana
2020-04-17,NC,5859,67122,72981,37,North Carolina
2020-04-17,ND,439,11903,12342,38,North Dakota
2020-04-17,NE,1066,12038,13104,31,Nebraska
2020-04-17,NH,1287,11421,12708,33,New Hampshire
2020-04-17,NJ,78467,78982,157449,34,New Jersey
2020-04-17,NM,1597,32891,34488,35,New Mexico
2020-04-17,NV,3524,26238,29762,32,Nevada
2020-04-17,NY,229642,343581,573223,36,New York
2020-04-17,OH,9107,68819,77926,39,Ohio
2020-04-17,OK,2465,31155,33620,40,Oklahoma
2020-04-17,OR,1785,34536,36321,41,Oregon
2020-04-17,PA,29441,117932,147373,42,Pennsylvania
2020-04-17,PR,1068,7864,8932,72,Puerto Rico
2020-04-17,RI,4177,26584,30761,44,Rhode Island
2020-04-17,SC,3931,32353,36284,45,South Carolina
2020-04-17,SD,1411,9651,11062,46,South Dakota
2020-04-17,TN,6589,80684,87273,47,Tennessee
2020-04-17,TX,17371,152165,169536,48,Texas
2020-04-17,UT,2805,52966,55771,49,Utah
2020-04-17,VA,7491,41506,48997,51,Virginia
2020-04-17,VI,51,373,424,78,U.S. Virgin Islands
2020-04-17,VT,802,10813,11615,50,Vermont
2020-04-17,WA,12849,140409,153258,53,Washington
2020-04-17,WI,4045,42365,46410,55,Wisconsin
2020-04-17,WV,754,17927,18681,54,West Virginia
2020-04-17,WY,296,6131,6427,56,Wyoming
2020-04-16,AK,300,8435,8735,02,Alaska
2020-04-16,AL,4345,32046,36391,01,Alabama
2020-04-16,AR,1620,21055,22675,05,Arkansas
2020-04-16,AS,0,3,3,60,American Samoa
2020-04-16,AZ,4234,43164,47398,04,Arizona
2020-04-16,CA,26182,220218,246400,06,California
2020-04-16,CO,8280,32253,40533,08,Colorado
2020-04-16,CT,15884,37238,53122,09,Connecticut
2020-04-16,DC,2350,9800,12150,11,District of Columbia
2020-04-16,DE,2075,11275,13350,10,Delaware
2020-04-16,FL,22897,196351,219248,12,Florida
2020-04-16,GA,15669,52270,67939,13,Georgia
2020-04-16,GU,133,870,1003,66,Guam
2020-04-16,HI,530,20170,20700,15,Hawaii
2020-04-16,IA,2141,18534,20675,19,Iowa
2020-04-16,ID,1587,14655,16242,16,Idaho
2020-04-16,IL,25733,96856,122589,17,Illinois
2020-04-16,IN,9542,41573,51115,18,Indiana
2020-04-16,KS,1588,14534,16122,20,Kansas
2020-04-16,KY,2291,26033,28324,21,Kentucky
2020-04-16,LA,22532,104054,126586,22,Louisiana
2020-04-16,MA,32492,110098,142590,25,Massachusetts
2020-04-16,MD,10784,48059,58843,24,Maryland
2020-04-16,ME,796,14076,14872,23,Maine
2020-04-16,MI,35455,78274,113729,26,Michigan
2020-04-16,MN,2486,42536,45022,27,Minnesota
2020-04-16,MO,5111,45537,50648,29,Missouri
2020-04-16,MP,13,27,40,69,Northern Mariana Islands
2020-04-16,MS,3624,34791,38415,28,Mississippi
2020-04-16,MT,415,9521,9936,30,Montana
2020-04-16,NC,5465,65452,70917,37,North Carolina
2020-04-16,ND,393,11311,11704,38,North Dakota
2020-04-16,NE,952,11342,12294,31,Nebraska
2020-04-16,NH,1139,11027,12166,33,New Hampshire
2020-04-16,NJ,75317,76513,151830,34,New Jersey
2020-04-16,NM,1484,31910,33394,35,New Mexico
2020-04-16,NV,3321,25130,28451,32,Nevada
2020-04-16,NY,222284,328295,550579,36,New York
2020-04-16,OH,8414,66426,74840,39,Ohio
2020-04-16,OK,2357,28542,30899,40,Oklahoma
2020-04-16,OR,1736,33202,34938,41,Oregon
2020-04-16,PA,27735,113735,141470,42,Pennsylvania
2020-04-16,PR,1043,7315,8358,72,Puerto Rico
2020-04-16,RI,3838,24226,28064,44,Rhode Island
2020-04-16,SC,3656,31077,34733,45,South Carolina
2020-04-16,SD,1311,9239,10550,46,South Dakota
2020-04-16,TN,6262,78787,85049,47,Tennessee
2020-04-16,TX,16455,142092,158547,48,Texas
2020-04-16,UT,2683,46995,49678,49,Utah
2020-04-16,VA,6889,39555,46444,51,Virginia
2020-04-16,VI,51,357,408,78,U.S. Virgin Islands
2020-04-16,VT,792,10259,11051,50,Vermont
2020-04-16,WA,12548,136262,148810,53,Washington
2020-04-16,WI,3875,40974,44849,55,Wisconsin
2020-04-16,WV,739,17567,18306,54,West Virginia
2020-04-16,WY,296,6131,6427,56,Wyoming
2020-04-15,AK,293,8371,8664,02,Alaska
2020-04-15,AL,4113,29964,34077,01,Alabama
2020-04-15,AR,1569,20265,21834,05,Arkansas
2020-04-15,AS,0,3,3,60,American Samoa
2020-04-15,AZ,3962,41348,45310,04,Arizona
2020-04-15,CA,24424,192062,216486,06,California
2020-04-15,CO,7941,31639,39580,08,Colorado
2020-04-15,CT,14755,35388,50143,09,Connecticut
2020-04-15,DC,2197,9328,11525,11,District of Columbia
2020-04-15,DE,2014,11088,13102,10,Delaware
2020-04-15,FL,22511,190998,213509,12,Florida
2020-04-15,GA,14987,49103,64090,13,Georgia
2020-04-15,GU,133,843,976,66,Guam
2020-04-15,HI,517,19286,19803,15,Hawaii
2020-04-15,IA,1995,17874,19869,19,Iowa
2020-04-15,ID,1464,13934,15398,16,Idaho
2020-04-15,IL,24593,92336,116929,17,Illinois
2020-04-15,IN,8955,39441,48396,18,Indiana
2020-04-15,KS,1494,13174,14668,20,Kansas
2020-04-15,KY,2210,25487,27697,21,Kentucky
2020-04-15,LA,21951,99977,121928,22,Louisiana
2020-04-15,MA,29970,102790,132760,25,Massachusetts
2020-04-15,MD,10032,45731,55763,24,Maryland
2020-04-15,ME,770,14076,14846,23,Maine
2020-04-15,MI,34533,73828,108361,26,Michigan
2020-04-15,MN,2321,41245,43566,27,Minnesota
2020-04-15,MO,4895,44117,49012,29,Missouri
2020-04-15,MP,13,27,40,69,Northern Mariana Islands
2020-04-15,MS,3360,34791,38151,28,Mississippi
2020-04-15,MT,404,9179,9583,30,Montana
2020-04-15,NC,5123,62704,67827,37,North Carolina
2020-04-15,ND,365,10952,11317,38,North Dakota
2020-04-15,NE,901,10828,11729,31,Nebraska
2020-04-15,NH,1139,11027,12166,33,New Hampshire
2020-04-15,NJ,71030,72991,144021,34,New Jersey
2020-04-15,NM,1407,31443,32850,35,New Mexico
2020-04-15,NV,3211,24444,27655,32,Nevada
2020-04-15,NY,213779,312233,526012,36,New York
2020-04-15,OH,7791,63761,71552,39,Ohio
2020-04-15,OK,2263,26956,29219,40,Oklahoma
2020-04-15,OR,1663,31688,33351,41,Oregon
2020-04-15,PA,26490,111094,137584,42,Pennsylvania
2020-04-15,PR,974,6825,7799,72,Puerto Rico
2020-04-15,RI,3529,22368,25897,44,Rhode Island
2020-04-15,SC,3656,31077,34733,45,South Carolina
2020-04-15,SD,1168,8691,9859,46,South Dakota
2020-04-15,TN,6079,74817,80896,47,Tennessee
2020-04-15,TX,15492,136318,151810,48,Texas
2020-04-15,UT,2542,45072,47614,49,Utah
2020-04-15,VA,6500,37669,44169,51,Virginia
2020-04-15,VI,51,331,382,78,U.S. Virgin Islands
2020-04-15,VT,779,9913,10692,50,Vermont
2020-04-15,WA,12293,132170,144463,53,Washington
2020-04-15,WI,3721,39326,43047,55,Wisconsin
2020-04-15,WV,702,16954,17656,54,West Virginia
2020-04-15,WY,287,6042,6329,56,Wyoming
2020-04-14,AK,285,8063,8348,02,Alaska
2020-04-14,AL,3876,29241,33117,01,Alabama
2020-04-14,AR,1480,19651,21131,05,Arkansas
2020-04-14,AS,0,3,3,60,American Samoa
2020-04-14,AZ,3806,40290,44096,04,Arizona
2020-04-14,CA,23338,178870,202208,06,California
2020-04-14,CO,7691,31051,38742,08,Colorado
2020-04-14,CT,13989,31852,45841,09,Connecticut
2020-04-14,DC,2058,9226,11284,11,District of Columbia
2020-04-14,DE,1761,10543,12304,10,Delaware
2020-04-14,FL,21367,181813,203180,12,Florida
2020-04-14,GA,14223,47572,61795,13,Georgia
2020-04-14,GU,133,811,944,66,Guam
2020-04-14,HI,504,18916,19420,15,Hawaii
2020-04-14,IA,1899,16986,18885,19,Iowa
2020-04-14,ID,1453,13661,15114,16,Idaho
2020-04-14,IL,23247,87369,110616,17,Illinois
2020-04-14,IN,8527,37490,46017,18,Indiana
2020-04-14,KS,1426,12721,14147,20,Kansas
2020-04-14,KY,2048,24635,26683,21,Kentucky
2020-04-14,LA,21518,96904,118422,22,Louisiana
2020-04-14,MA,28109,98820,126929,25,Massachusetts
2020-04-14,MD,9472,44261,53733,24,Maryland
2020-04-14,ME,734,11608,12342,23,Maine
2020-04-14,MI,33613,70675,104288,26,Michigan
2020-04-14,MN,2165,39705,41870,27,Minnesota
2020-04-14,MO,4686,43292,47978,29,Missouri
2020-04-14,MP,13,27,40,69,Northern Mariana Islands
2020-04-14,MS,3087,34791,37878,28,Mississippi
2020-04-14,MT,399,8835,9234,30,Montana
2020-04-14,NC,5024,60015,65039,37,North Carolina
2020-04-14,ND,341,10575,10916,38,North Dakota
2020-04-14,NE,871,10486,11357,31,Nebraska
2020-04-14,NH,1020,10590,11610,33,New Hampshire
2020-04-14,NJ,68824,70950,139774,34,New Jersey
2020-04-14,NM,1345,30625,31970,35,New Mexico
2020-04-14,NV,3088,23573,26661,32,Nevada
2020-04-14,NY,202208,296935,499143,36,New York
2020-04-14,OH,7280,60721,68001,39,Ohio
2020-04-14,OK,2184,26085,28269,40,Oklahoma
2020-04-14,OR,1633,30730,32363,41,Oregon
2020-04-14,PA,25345,108286,133631,42,Pennsylvania
2020-04-14,PR,923,6284,7207,72,Puerto Rico
2020-04-14,RI,3251,19649,22900,44,Rhode Island
2020-04-14,SC,3553,30319,33872,45,South Carolina
2020-04-14,SD,988,8308,9296,46,South Dakota
2020-04-14,TN,5823,73008,78831,47,Tennessee
2020-04-14,TX,14624,131843,146467,48,Texas
2020-04-14,UT,2412,44064,46476,49,Utah
2020-04-14,VA,6171,36592,42763,51,Virginia
2020-04-14,VI,51,326,377,78,U.S. Virgin Islands
2020-04-14,VT,770,9491,10261,50,Vermont
2020-04-14,WA,11981,128338,140319,53,Washington
2020-04-14,WI,3555,37997,41552,55,Wisconsin
2020-04-14,WV,640,16398,17038,54,West Virginia
2020-04-14,WY,275,5689,5964,56,Wyoming
2020-04-13,AK,277,7553,7830,02,Alaska
2020-04-13,AL,3734,25448,29182,01,Alabama
2020-04-13,AR,1410,19394,20804,05,Arkansas
2020-04-13,AS,0,3,3,60,American Samoa
2020-04-13,AZ,3702,39645,43347,04,Arizona
2020-04-13,CA,22348,168534,190882,06,California
2020-04-13,CO,7684,29850,37534,08,Colorado
2020-04-13,CT,13381,30928,44309,09,Connecticut
2020-04-13,DC,1955,8979,10934,11,District of Columbia
2020-04-13,DE,1625,10195,11820,10,Delaware
2020-04-13,FL,20601,175606,196207,12,Florida
2020-04-13,GA,13315,43706,57021,13,Georgia
2020-04-13,GU,133,770,903,66,Guam
2020-04-13,HI,499,18345,18844,15,Hawaii
2020-04-13,IA,1710,16986,18696,19,Iowa
2020-04-13,ID,1426,13455,14881,16,Idaho
2020-04-13,IL,22025,83743,105768,17,Illinois
2020-04-13,IN,8236,36303,44539,18,Indiana
2020-04-13,KS,1376,12488,13864,20,Kansas
2020-04-13,KY,1963,23903,25866,21,Kentucky
2020-04-13,LA,21016,87075,108091,22,Louisiana
2020-04-13,MA,26794,95500,122294,25,Massachusetts
2020-04-13,MD,8936,42815,51751,24,Maryland
2020-04-13,ME,698,11608,12306,23,Maine
2020-04-13,MI,32702,67063,99765,26,Michigan
2020-04-13,MN,2012,38667,40679,27,Minnesota
2020-04-13,MO,4388,41040,45428,29,Missouri
2020-04-13,MP,11,27,38,69,Northern Mariana Islands
2020-04-13,MS,2942,28042,30984,28,Mississippi
2020-04-13,MT,394,8704,9098,30,Montana
2020-04-13,NC,4816,58572,63388,37,North Carolina
2020-04-13,ND,331,10450,10781,38,North Dakota
2020-04-13,NE,814,10158,10972,31,Nebraska
2020-04-13,NH,985,10222,11207,33,New Hampshire
2020-04-13,NJ,64584,64885,129469,34,New Jersey
2020-04-13,NM,1245,29270,30515,35,New Mexico
2020-04-13,NV,2971,22493,25464,32,Nevada
2020-04-13,NY,195031,283326,478357,36,New York
2020-04-13,OH,6975,58137,65112,39,Ohio
2020-04-13,OK,2069,20790,22859,40,Oklahoma
2020-04-13,OR,1584,29537,31121,41,Oregon
2020-04-13,PA,24199,105593,129792,42,Pennsylvania
2020-04-13,PR,903,5960,6863,72,Puerto Rico
2020-04-13,RI,2976,17685,20661,44,Rhode Island
2020-04-13,SC,3319,28106,31425,45,South Carolina
2020-04-13,SD,868,8134,9002,46,South Dakota
2020-04-13,TN,5610,70585,76195,47,Tennessee
2020-04-13,TX,13906,119320,133226,48,Texas
2020-04-13,UT,2363,43424,45787,49,Utah
2020-04-13,VA,5747,35654,41401,51,Virginia
2020-04-13,VI,51,322,373,78,U.S. Virgin Islands
2020-04-13,VT,761,9275,10036,50,Vermont
2020-04-13,WA,11757,124272,136029,53,Washington
2020-04-13,WI,3428,36769,40197,55,Wisconsin
2020-04-13,WV,626,16029,16655,54,West Virginia
2020-04-13,WY,275,5689,5964,56,Wyoming
2020-04-12,AK,272,7766,8038,02,Alaska
2020-04-12,AL,3525,18058,21583,01,Alabama
2020-04-12,AR,1280,18442,19722,05,Arkansas
2020-04-12,AS,0,3,3,60,American Samoa
2020-04-12,AZ,3539,38570,42109,04,Arizona
2020-04-12,CA,21794,168534,190328,06,California
2020-04-12,CO,6893,27980,34873,08,Colorado
2020-04-12,CT,12035,29185,41220,09,Connecticut
2020-04-12,DC,1875,8765,10640,11,District of Columbia
2020-04-12,DE,1479,9624,11103,10,Delaware
2020-04-12,FL,19355,163398,182753,12,Florida
2020-04-12,GA,12452,42001,54453,13,Georgia
2020-04-12,GU,133,693,826,66,Guam
2020-04-12,HI,486,17482,17968,15,Hawaii
2020-04-12,IA,1587,16005,17592,19,Iowa
2020-04-12,ID,1407,12901,14308,16,Idaho
2020-04-12,IL,20852,79883,100735,17,Illinois
2020-04-12,IN,7928,34561,42489,18,Indiana
2020-04-12,KS,1337,11916,13253,20,Kansas
2020-04-12,KY,1840,22727,24567,21,Kentucky
2020-04-12,LA,20595,83450,104045,22,Louisiana
2020-04-12,MA,25381,91463,116844,25,Massachusetts
2020-04-12,MD,8225,41539,49764,24,Maryland
2020-04-12,ME,633,6088,6721,23,Maine
2020-04-12,MI,31666,64555,96221,26,Michigan
2020-04-12,MN,1864,38030,39894,27,Minnesota
2020-04-12,MO,4160,41040,45200,29,Missouri
2020-04-12,MP,11,27,38,69,Northern Mariana Islands
2020-04-12,MS,2781,18632,21413,28,Mississippi
2020-04-12,MT,387,8526,8913,30,Montana
2020-04-12,NC,4520,57619,62139,37,North Carolina
2020-04-12,ND,308,10042,10350,38,North Dakota
2020-04-12,NE,791,9900,10691,31,Nebraska
2020-04-12,NH,929,9996,10925,33,New Hampshire
2020-04-12,NJ,61850,64885,126735,34,New Jersey
2020-04-12,NM,1174,27518,28692,35,New Mexico
2020-04-12,NV,2836,21775,24611,32,Nevada
2020-04-12,NY,188694,272907,461601,36,New York
2020-04-12,OH,6604,56639,63243,39,Ohio
2020-04-12,OK,1970,20790,22760,40,Oklahoma
2020-04-12,OR,1527,28231,29758,41,Oregon
2020-04-12,PA,22833,102057,124890,42,Pennsylvania
2020-04-12,PR,897,5819,6716,72,Puerto Rico
2020-04-12,RI,2665,17685,20350,44,Rhode Island
2020-04-12,SC,3319,28106,31425,45,South Carolina
2020-04-12,SD,730,7823,8553,46,South Dakota
2020-04-12,TN,5308,65369,70677,47,Tennessee
2020-04-12,TX,13484,111049,124533,48,Texas
2020-04-12,UT,2303,41931,44234,49,Utah
2020-04-12,VA,5274,34711,39985,51,Virginia
2020-04-12,VI,51,299,350,78,U.S. Virgin Islands
2020-04-12,VT,754,8724,9478,50,Vermont
2020-04-12,WA,11457,120372,131829,53,Washington
2020-04-12,WI,3341,35916,39257,55,Wisconsin
2020-04-12,WV,611,15646,16257,54,West Virginia
2020-04-12,WY,261,5198,5459,56,Wyoming
2020-04-11,AK,257,7475,7732,02,Alaska
2020-04-11,AL,3191,18058,21249,01,Alabama
2020-04-11,AR,1226,17352,18578,05,Arkansas
2020-04-11,AS,0,3,3,60,American Samoa
2020-04-11,AZ,3393,37137,40530,04,Arizona
2020-04-11,CA,20615,152604,173219,06,California
2020-04-11,CO,6510,26143,32653,08,Colorado
2020-04-11,CT,11510,28321,39831,09,Connecticut
2020-04-11,DC,1778,8261,10039,11,District of Columbia
2020-04-11,DE,1479,9624,11103,10,Delaware
2020-04-11,FL,18494,154439,172933,12,Florida
2020-04-11,GA,12159,39556,51715,13,Georgia
2020-04-11,GU,133,693,826,66,Guam
2020-04-11,HI,465,17066,17531,15,Hawaii
2020-04-11,IA,1510,15622,17132,19,Iowa
2020-04-11,ID,1396,12368,13764,16,Idaho
2020-04-11,IL,19180,72969,92149,17,Illinois
2020-04-11,IN,7435,31780,39215,18,Indiana
2020-04-11,KS,1268,11075,12343,20,Kansas
2020-04-11,KY,1693,22595,24288,21,Kentucky
2020-04-11,LA,20014,76901,96915,22,Louisiana
2020-04-11,MA,22766,86115,108881,25,Massachusetts
2020-04-11,MD,7694,39544,47238,24,Maryland
2020-04-11,ME,616,6088,6704,23,Maine
2020-04-11,MI,30980,62241,93221,26,Michigan
2020-04-11,MN,1806,36898,38704,27,Minnesota
2020-04-11,MO,4024,39148,43172,29,Missouri
2020-04-11,MP,11,27,38,69,Northern Mariana Islands
2020-04-11,MS,2642,18632,21274,28,Mississippi
2020-04-11,MT,377,8204,8581,30,Montana
2020-04-11,NC,4312,56081,60393,37,North Carolina
2020-04-11,ND,293,9787,10080,38,North Dakota
2020-04-11,NE,700,9285,9985,31,Nebraska
2020-04-11,NH,885,9608,10493,33,New Hampshire
2020-04-11,NJ,58151,62042,120193,34,New Jersey
2020-04-11,NM,1091,26007,27098,35,New Mexico
2020-04-11,NV,2700,20887,23587,32,Nevada
2020-04-11,NY,180458,260522,440980,36,New York
2020-04-11,OH,6250,54221,60471,39,Ohio
2020-04-11,OK,1868,20790,22658,40,Oklahoma
2020-04-11,OR,1371,25853,27224,41,Oregon
2020-04-11,PA,21655,98498,120153,42,Pennsylvania
2020-04-11,PR,788,5583,6371,72,Puerto Rico
2020-04-11,RI,2349,15858,18207,44,Rhode Island
2020-04-11,SC,3207,26886,30093,45,South Carolina
2020-04-11,SD,626,7378,8004,46,South Dakota
2020-04-11,TN,5114,61714,66828,47,Tennessee
2020-04-11,TX,12561,107972,120533,48,Texas
2020-04-11,UT,2206,40340,42546,49,Utah
2020-04-11,VA,5077,32922,37999,51,Virginia
2020-04-11,VI,51,299,350,78,U.S. Virgin Islands
2020-04-11,VT,733,8063,8796,50,Vermont
2020-04-11,WA,11290,119108,130398,53,Washington
2020-04-11,WI,3213,34680,37893,55,Wisconsin
2020-04-11,WV,577,14875,15452,54,West Virginia
2020-04-11,WY,261,5198,5459,56,Wyoming
2020-04-10,AK,246,7186,7432,02,Alaska
2020-04-10,AL,2968,18058,21026,01,Alabama
2020-04-10,AR,1171,15949,17120,05,Arkansas
2020-04-10,AS,0,3,3,60,American Samoa
2020-04-10,AZ,3112,34622,37734,04,Arizona
2020-04-10,CA,19472,145391,164863,06,California
2020-04-10,CO,6510,26143,32653,08,Colorado
2020-04-10,CT,10538,25750,36288,09,Connecticut
2020-04-10,DC,1660,7695,9355,11,District of Columbia
2020-04-10,DE,1326,10415,11741,10,Delaware
2020-04-10,FL,17531,145299,162830,12,Florida
2020-04-10,GA,11483,34664,46147,13,Georgia
2020-04-10,GU,130,662,792,66,Guam
2020-04-10,HI,442,15707,16149,15,Hawaii
2020-04-10,IA,1388,14565,15953,19,Iowa
2020-04-10,ID,1353,11741,13094,16,Idaho
2020-04-10,IL,17887,69640,87527,17,Illinois
2020-04-10,IN,6907,28133,35040,18,Indiana
2020-04-10,KS,1166,10248,11414,20,Kansas
2020-04-10,KY,1693,22595,24288,21,Kentucky
2020-04-10,LA,19253,73027,92280,22,Louisiana
2020-04-10,MA,20878,81564,102442,25,Massachusetts
2020-04-10,MD,6968,37480,44448,24,Maryland
2020-04-10,ME,586,6088,6674,23,Maine
2020-04-10,MI,30172,59597,89769,26,Michigan
2020-04-10,MN,1732,35346,37078,27,Minnesota
2020-04-10,MO,3799,36941,40740,29,Missouri
2020-04-10,MP,11,27,38,69,Northern Mariana Islands
2020-04-10,MS,2469,18632,21101,28,Mississippi
2020-04-10,MT,365,7932,8297,30,Montana
2020-04-10,NC,3908,53737,57645,37,North Carolina
2020-04-10,ND,278,9330,9608,38,North Dakota
2020-04-10,NE,635,8719,9354,31,Nebraska
2020-04-10,NH,819,9139,9958,33,New Hampshire
2020-04-10,NJ,54588,58935,113523,34,New Jersey
2020-04-10,NM,1091,26007,27098,35,New Mexico
2020-04-10,NV,2584,20165,22749,32,Nevada
2020-04-10,NY,170512,247373,417885,36,New York
2020-04-10,OH,5878,52695,58573,39,Ohio
2020-04-10,OK,1794,20370,22164,40,Oklahoma
2020-04-10,OR,1321,24306,25627,41,Oregon
2020-04-10,PA,19979,93040,113019,42,Pennsylvania
2020-04-10,PR,725,5121,5846,72,Puerto Rico
2020-04-10,RI,2015,12281,14296,44,Rhode Island
2020-04-10,SC,3065,25118,28183,45,South Carolina
2020-04-10,SD,536,7111,7647,46,South Dakota
2020-04-10,TN,4862,57937,62799,47,Tennessee
2020-04-10,TX,11671,104047,115718,48,Texas
2020-04-10,UT,2102,38660,40762,49,Utah
2020-04-10,VA,4509,30950,35459,51,Virginia
2020-04-10,VI,50,273,323,78,U.S. Virgin Islands
2020-04-10,VT,713,7502,8215,50,Vermont
2020-04-10,WA,11080,117241,128321,53,Washington
2020-04-10,WI,3068,33225,36293,55,Wisconsin
2020-04-10,WV,554,14001,14555,54,West Virginia
2020-04-10,WY,253,4736,4989,56,Wyoming
2020-04-09,AK,235,6988,7223,02,Alaska
2020-04-09,AL,2769,18058,20827,01,Alabama
2020-04-09,AR,1119,13832,14951,05,Arkansas
2020-04-09,AS,0,3,3,60,American Samoa
2020-04-09,AZ,3018,34160,37178,04,Arizona
2020-04-09,CA,18309,145191,163500,06,California
2020-04-09,CO,5655,23544,29199,08,Colorado
2020-04-09,CT,9784,23718,33502,09,Connecticut
2020-04-09,DC,1523,7201,8724,11,District of Columbia
2020-04-09,DE,1207,8683,9890,10,Delaware
2020-04-09,FL,16364,136185,152549,12,Florida
2020-04-09,GA,10566,30519,41085,13,Georgia
2020-04-09,GU,128,593,721,66,Guam
2020-04-09,HI,435,15316,15751,15,Hawaii
2020-04-09,IA,1270,13703,14973,19,Iowa
2020-04-09,ID,1232,11299,12531,16,Idaho
2020-04-09,IL,16422,64435,80857,17,Illinois
2020-04-09,IN,6351,25782,32133,18,Indiana
2020-04-09,KS,1106,9669,10775,20,Kansas
2020-04-09,KY,1346,20455,21801,21,Kentucky
2020-04-09,LA,18283,68636,86919,22,Louisiana
2020-04-09,MA,18843,76146,94989,25,Massachusetts
2020-04-09,MD,6185,35344,41529,24,Maryland
2020-04-09,ME,560,6088,6648,23,Maine
2020-04-09,MI,29096,56430,85526,26,Michigan
2020-04-09,MN,1637,33682,35319,27,Minnesota
2020-04-09,MO,3539,34955,38494,29,Missouri
2020-04-09,MP,11,27,38,69,Northern Mariana Islands
2020-04-09,MS,2260,18632,20892,28,Mississippi
2020-04-09,MT,354,7506,7860,30,Montana
2020-04-09,NC,3651,44158,47809,37,North Carolina
2020-04-09,ND,269,8721,8990,38,North Dakota
2020-04-09,NE,567,8116,8683,31,Nebraska
2020-04-09,NH,788,8763,9551,33,New Hampshire
2020-04-09,NJ,51027,56165,107192,34,New Jersey
2020-04-09,NM,865,22942,23807,35,New Mexico
2020-04-09,NV,2456,19315,21771,32,Nevada
2020-04-09,NY,159937,231612,391549,36,New York
2020-04-09,OH,5512,50473,55985,39,Ohio
2020-04-09,OK,1684,18595,20279,40,Oklahoma
2020-04-09,OR,1321,24306,25627,41,Oregon
2020-04-09,PA,18228,87374,105602,42,Pennsylvania
2020-04-09,PR,683,4703,5386,72,Puerto Rico
2020-04-09,RI,1727,10682,12409,44,Rhode Island
2020-04-09,SC,2792,24575,27367,45,South Carolina
2020-04-09,SD,447,6700,7147,46,South Dakota
2020-04-09,TN,4634,55215,59849,47,Tennessee
2020-04-09,TX,10230,95904,106134,48,Texas
2020-04-09,UT,1976,36397,38373,49,Utah
2020-04-09,VA,4042,28984,33026,51,Virginia
2020-04-09,VI,46,251,297,78,U.S. Virgin Islands
2020-04-09,VT,680,7218,7898,50,Vermont
2020-04-09,WA,10805,113213,124018,53,Washington
2020-04-09,WI,2885,31424,34309,55,Wisconsin
2020-04-09,WV,523,13340,13863,54,West Virginia
2020-04-09,WY,230,3920,4150,56,Wyoming
2020-04-08,AK,226,6842,7068,02,Alaska
2020-04-08,AL,2369,16753,19122,01,Alabama
2020-04-08,AR,1000,13530,14530,05,Arkansas
2020-04-08,AS,0,3,3,60,American Samoa
2020-04-08,AZ,2726,31838,34564,04,Arizona
2020-04-08,CA,16957,127307,144264,06,California
2020-04-08,CO,5429,22665,28094,08,Colorado
2020-04-08,CT,7781,21255,29036,09,Connecticut
2020-04-08,DC,1440,6843,8283,11,District of Columbia
2020-04-08,DE,928,7628,8556,10,Delaware
2020-04-08,FL,15455,127679,143134,12,Florida
2020-04-08,GA,9901,28886,38787,13,Georgia
2020-04-08,GU,125,562,687,66,Guam
2020-04-08,HI,410,14739,15149,15,Hawaii
2020-04-08,IA,1145,12821,13966,19,Iowa
2020-04-08,ID,1210,10688,11898,16,Idaho
2020-04-08,IL,15078,59988,75066,17,Illinois
2020-04-08,IN,5943,24926,30869,18,Indiana
2020-04-08,KS,1046,9137,10183,20,Kansas
2020-04-08,KY,1149,20455,21604,21,Kentucky
2020-04-08,LA,17030,64376,81406,22,Louisiana
2020-04-08,MA,16692,70849,87541,25,Massachusetts
2020-04-08,MD,5529,32933,38462,24,Maryland
2020-04-08,ME,537,6088,6625,23,Maine
2020-04-08,MI,28064,53176,81240,26,Michigan
2020-04-08,MN,1534,31954,33488,27,Minnesota
2020-04-08,MO,3327,30783,34110,29,Missouri
2020-04-08,MP,11,27,38,69,Northern Mariana Islands
2020-04-08,MS,2003,18632,20635,28,Mississippi
2020-04-08,MT,332,7066,7398,30,Montana
2020-04-08,NC,3426,39561,42987,37,North Carolina
2020-04-08,ND,251,8301,8552,38,North Dakota
2020-04-08,NE,519,7442,7961,31,Nebraska
2020-04-08,NH,788,8389,9177,33,New Hampshire
2020-04-08,NJ,47437,52979,100416,34,New Jersey
2020-04-08,NM,794,21451,22245,35,New Mexico
2020-04-08,NV,2318,18248,20566,32,Nevada
2020-04-08,NY,149316,215837,365153,36,New York
2020-04-08,OH,5148,48193,53341,39,Ohio
2020-04-08,OK,1524,11821,13345,40,Oklahoma
2020-04-08,OR,1239,23325,24564,41,Oregon
2020-04-08,PA,16239,82299,98538,42,Pennsylvania
2020-04-08,PR,620,4266,4886,72,Puerto Rico
2020-04-08,RI,1450,10682,12132,44,Rhode Island
2020-04-08,SC,2552,22082,24634,45,South Carolina
2020-04-08,SD,393,6355,6748,46,South Dakota
2020-04-08,TN,4362,52256,56618,47,Tennessee
2020-04-08,TX,9353,86905,96258,48,Texas
2020-04-08,UT,1846,34270,36116,49,Utah
2020-04-08,VA,3645,27000,30645,51,Virginia
2020-04-08,VI,45,242,287,78,U.S. Virgin Islands
2020-04-08,VT,631,7001,7632,50,Vermont
2020-04-08,WA,10518,109180,119698,53,Washington
2020-04-08,WI,2756,30115,32871,55,Wisconsin
2020-04-08,WV,462,12083,12545,54,West Virginia
2020-04-08,WY,221,3843,4064,56,Wyoming
2020-04-07,AK,213,6700,6913,02,Alaska
2020-04-07,AL,2119,12797,14916,01,Alabama
2020-04-07,AR,946,12692,13638,05,Arkansas
2020-04-07,AS,0,3,3,60,American Samoa
2020-04-07,AZ,2575,30800,33375,04,Arizona
2020-04-07,CA,15865,115364,131229,06,California
2020-04-07,CO,5172,21703,26875,08,Colorado
2020-04-07,CT,7781,21255,29036,09,Connecticut
2020-04-07,DC,1211,6612,7823,11,District of Columbia
2020-04-07,DE,928,7628,8556,10,Delaware
2020-04-07,FL,14747,123415,138162,12,Florida
2020-04-07,GA,8818,24895,33713,13,Georgia
2020-04-07,GU,121,529,650,66,Guam
2020-04-07,HI,387,13155,13542,15,Hawaii
2020-04-07,IA,1048,11670,12718,19,Iowa
2020-04-07,ID,1170,10076,11246,16,Idaho
2020-04-07,IL,13549,55183,68732,17,Illinois
2020-04-07,IN,5507,23257,28764,18,Indiana
2020-04-07,KS,900,8614,9514,20,Kansas
2020-04-07,KY,1008,18947,19955,21,Kentucky
2020-04-07,LA,16284,58371,74655,22,Louisiana
2020-04-07,MA,15104,66270,81374,25,Massachusetts
2020-04-07,MD,4371,27256,31627,24,Maryland
2020-04-07,ME,519,6088,6607,23,Maine
2020-04-07,MI,26964,50344,77308,26,Michigan
2020-04-07,MN,1432,30603,32035,27,Minnesota
2020-04-07,MO,3037,28932,31969,29,Missouri
2020-04-07,MP,8,15,23,69,Northern Mariana Islands
2020-04-07,MS,1915,18632,20547,28,Mississippi
2020-04-07,MT,319,6666,6985,30,Montana
2020-04-07,NC,3221,37861,41082,37,North Carolina
2020-04-07,ND,237,7466,7703,38,North Dakota
2020-04-07,NE,447,6811,7258,31,Nebraska
2020-04-07,NH,715,8019,8734,33,New Hampshire
2020-04-07,NJ,44416,50558,94974,34,New Jersey
2020-04-07,NM,686,21139,21825,35,New Mexico
2020-04-07,NV,2087,16552,18639,32,Nevada
2020-04-07,NY,138863,201195,340058,36,New York
2020-04-07,OH,4782,46056,50838,39,Ohio
2020-04-07,OK,1472,11821,13293,40,Oklahoma
2020-04-07,OR,1181,21826,23007,41,Oregon
2020-04-07,PA,14559,76719,91278,42,Pennsylvania
2020-04-07,PR,573,3966,4539,72,Puerto Rico
2020-04-07,RI,1230,9077,10307,44,Rhode Island
2020-04-07,SC,2417,21263,23680,45,South Carolina
2020-04-07,SD,320,5948,6268,46,South Dakota
2020-04-07,TN,4138,48736,52874,47,Tennessee
2020-04-07,TX,8262,80387,88649,48,Texas
2020-04-07,UT,1738,32909,34647,49,Utah
2020-04-07,VA,3333,25312,28645,51,Virginia
2020-04-07,VI,43,222,265,78,U.S. Virgin Islands
2020-04-07,VT,608,6645,7253,50,Vermont
2020-04-07,WA,10236,104655,114891,53,Washington
2020-04-07,WI,2578,28512,31090,55,Wisconsin
2020-04-07,WV,412,11647,12059,54,West Virginia
2020-04-07,WY,216,3789,4005,56,Wyoming
2020-04-06,AK,191,6692,6883,02,Alaska
2020-04-06,AL,1968,12797,14765,01,Alabama
2020-04-06,AR,875,11970,12845,05,Arkansas
2020-04-06,AS,0,3,3,60,American Samoa
2020-04-06,AZ,2456,30078,32534,04,Arizona
2020-04-06,CA,14336,103095,117431,06,California
2020-04-06,CO,4950,20823,25773,08,Colorado
2020-04-06,CT,6906,19780,26686,09,Connecticut
2020-04-06,DC,1097,6356,7453,11,District of Columbia
2020-04-06,DE,673,6321,6994,10,Delaware
2020-04-06,FL,13324,109950,123274,12,Florida
2020-04-06,GA,7314,23960,31274,13,Georgia
2020-04-06,GU,113,505,618,66,Guam
2020-04-06,HI,371,13155,13526,15,Hawaii
2020-04-06,IA,946,10653,11599,19,Iowa
2020-04-06,ID,1101,9894,10995,16,Idaho
2020-04-06,IL,12262,50680,62942,17,Illinois
2020-04-06,IN,4944,21247,26191,18,Indiana
2020-04-06,KS,845,8239,9084,20,Kansas
2020-04-06,KY,955,17812,18767,21,Kentucky
2020-04-06,LA,14867,54299,69166,22,Louisiana
2020-04-06,MA,13739,62720,76459,25,Massachusetts
2020-04-06,MD,4045,25572,29617,24,Maryland
2020-04-06,ME,499,6088,6587,23,Maine
2020-04-06,MI,25785,47262,73047,26,Michigan
2020-04-06,MN,1330,29155,30485,27,Minnesota
2020-04-06,MO,2722,27113,29835,29,Missouri
2020-04-06,MP,8,13,21,69,Northern Mariana Islands
2020-04-06,MS,1738,18632,20370,28,Mississippi
2020-04-06,MT,299,6491,6790,30,Montana
2020-04-06,NC,2870,37856,40726,37,North Carolina
2020-04-06,ND,225,6988,7213,38,North Dakota
2020-04-06,NE,409,6378,6787,31,Nebraska
2020-04-06,NH,669,7701,8370,33,New Hampshire
2020-04-06,NJ,41090,47942,89032,34,New Jersey
2020-04-06,NM,624,18512,19136,35,New Mexico
2020-04-06,NV,1953,15676,17629,32,Nevada
2020-04-06,NY,130689,190122,320811,36,New York
2020-04-06,OH,4450,43928,48378,39,Ohio
2020-04-06,OK,1327,1422,2749,40,Oklahoma
2020-04-06,OR,1132,20669,21801,41,Oregon
2020-04-06,PA,12980,70874,83854,42,Pennsylvania
2020-04-06,PR,513,3432,3945,72,Puerto Rico
2020-04-06,RI,1082,7399,8481,44,Rhode Island
2020-04-06,SC,2049,16927,18976,45,South Carolina
2020-04-06,SD,288,5732,6020,46,South Dakota
2020-04-06,TN,3802,43548,47350,47,Tennessee
2020-04-06,TX,7276,78081,85357,48,Texas
2020-04-06,UT,1675,31719,33394,49,Utah
2020-04-06,VA,2878,21643,24521,51,Virginia
2020-04-06,VI,43,222,265,78,U.S. Virgin Islands
2020-04-06,VT,575,6161,6736,50,Vermont
2020-04-06,WA,9973,99677,109650,53,Washington
2020-04-06,WI,2440,26574,29014,55,Wisconsin
2020-04-06,WV,345,9595,9940,54,West Virginia
2020-04-06,WY,210,3719,3929,56,Wyoming
2020-04-05,AK,185,6099,6284,02,Alaska
2020-04-05,AL,1796,11282,13078,01,Alabama
2020-04-05,AR,830,10412,11242,05,Arkansas
2020-04-05,AS,0,3,3,60,American Samoa
2020-04-05,AZ,2269,25141,27410,04,Arizona
2020-04-05,CA,13438,103095,116533,06,California
2020-04-05,CO,4565,19335,23900,08,Colorado
2020-04-05,CT,5675,17595,23270,09,Connecticut
2020-04-05,DC,998,5836,6834,11,District of Columbia
2020-04-05,DE,673,6321,6994,10,Delaware
2020-04-05,FL,12151,101253,113404,12,Florida
2020-04-05,GA,6647,21185,27832,13,Georgia
2020-04-05,GU,112,493,605,66,Guam
2020-04-05,HI,351,12604,12955,15,Hawaii
2020-04-05,IA,868,9973,10841,19,Iowa
2020-04-05,ID,1077,9184,10261,16,Idaho
2020-04-05,IL,11256,47727,58983,17,Illinois
2020-04-05,IN,4411,18241,22652,18,Indiana
2020-04-05,KS,747,7476,8223,20,Kansas
2020-04-05,KY,917,15746,16663,21,Kentucky
2020-04-05,LA,13010,47315,60325,22,Louisiana
2020-04-05,MA,12402,59565,71967,25,Massachusetts
2020-04-05,MD,3609,24728,28337,24,Maryland
2020-04-05,ME,470,6088,6558,23,Maine
2020-04-05,MI,24458,44154,68612,26,Michigan
2020-04-05,MN,1217,28090,29307,27,Minnesota
2020-04-05,MO,2367,24882,27249,29,Missouri
2020-04-05,MP,8,13,21,69,Northern Mariana Islands
2020-04-05,MS,1638,5580,7218,28,Mississippi
2020-04-05,MT,286,6317,6603,30,Montana
2020-04-05,NC,2585,37460,40045,37,North Carolina
2020-04-05,ND,207,6580,6787,38,North Dakota
2020-04-05,NE,363,5558,5921,31,Nebraska
2020-04-05,NH,621,7411,8032,33,New Hampshire
2020-04-05,NJ,37505,44661,82166,34,New Jersey
2020-04-05,NM,543,16285,16828,35,New Mexico
2020-04-05,NV,1836,14995,16831,32,Nevada
2020-04-05,NY,122031,180249,302280,36,New York
2020-04-05,OH,4043,39713,43756,39,Ohio
2020-04-05,OK,1252,1401,2653,40,Oklahoma
2020-04-05,OR,1068,19556,20624,41,Oregon
2020-04-05,PA,11510,66261,77771,42,Pennsylvania
2020-04-05,PR,475,3073,3548,72,Puerto Rico
2020-04-05,RI,922,6259,7181,44,Rhode Island
2020-04-05,SC,2049,16927,18976,45,South Carolina
2020-04-05,SD,240,5353,5593,46,South Dakota
2020-04-05,TN,3633,41667,45300,47,Tennessee
2020-04-05,TX,6812,64126,70938,48,Texas
2020-04-05,UT,1605,29287,30892,49,Utah
2020-04-05,VA,2637,21034,23671,51,Virginia
2020-04-05,VI,42,206,248,78,U.S. Virgin Islands
2020-04-05,VT,543,5830,6373,50,Vermont
2020-04-05,WA,9649,94856,104505,53,Washington
2020-04-05,WI,2267,25169,27436,55,Wisconsin
2020-04-05,WV,324,8514,8838,54,West Virginia
2020-04-05,WY,197,3040,3237,56,Wyoming
2020-04-04,AK,171,5869,6040,02,Alaska
2020-04-04,AL,1580,9273,10853,01,Alabama
2020-04-04,AR,743,9627,10370,05,Arkansas
2020-04-04,AS,0,3,3,60,American Samoa
2020-04-04,AZ,2019,25141,27160,04,Arizona
2020-04-04,CA,12026,101674,113700,06,California
2020-04-04,CO,4173,17898,22071,08,Colorado
2020-04-04,CT,5276,16753,22029,09,Connecticut
2020-04-04,DC,902,5536,6438,11,District of Columbia
2020-04-04,DE,593,5874,6467,10,Delaware
2020-04-04,FL,11111,90956,102067,12,Florida
2020-04-04,GA,6160,20134,26294,13,Georgia
2020-04-04,GU,93,472,565,66,Guam
2020-04-04,HI,319,11959,12278,15,Hawaii
2020-04-04,IA,786,9454,10240,19,Iowa
2020-04-04,ID,1013,7857,8870,16,Idaho
2020-04-04,IL,10357,43224,53581,17,Illinois
2020-04-04,IN,3953,15847,19800,18,Indiana
2020-04-04,KS,698,6880,7578,20,Kansas
2020-04-04,KY,831,14741,15572,21,Kentucky
2020-04-04,LA,12496,46002,58498,22,Louisiana
2020-04-04,MA,11637,57191,68828,25,Massachusetts
2020-04-04,MD,3125,22485,25610,24,Maryland
2020-04-04,ME,456,6088,6544,23,Maine
2020-04-04,MI,23581,41205,64786,26,Michigan
2020-04-04,MN,1158,26687,27845,27,Minnesota
2020-04-04,MO,2291,22614,24905,29,Missouri
2020-04-04,MP,8,13,21,69,Northern Mariana Islands
2020-04-04,MS,1455,5133,6588,28,Mississippi
2020-04-04,MT,265,5912,6177,30,Montana
2020-04-04,NC,2402,36371,38773,37,North Carolina
2020-04-04,ND,186,6021,6207,38,North Dakota
2020-04-04,NE,321,5058,5379,31,Nebraska
2020-04-04,NH,540,6965,7505,33,New Hampshire
2020-04-04,NJ,34124,41232,75356,34,New Jersey
2020-04-04,NM,495,15137,15632,35,New Mexico
2020-04-04,NV,1742,14421,16163,32,Nevada
2020-04-04,NY,113704,169917,283621,36,New York
2020-04-04,OH,3739,38132,41871,39,Ohio
2020-04-04,OK,1159,1362,2521,40,Oklahoma
2020-04-04,OR,999,16535,17534,41,Oregon
2020-04-04,PA,10017,60013,70030,42,Pennsylvania
2020-04-04,PR,452,2605,3057,72,Puerto Rico
2020-04-04,RI,806,5584,6390,44,Rhode Island
2020-04-04,SC,1917,16397,18314,45,South Carolina
2020-04-04,SD,212,5012,5224,46,South Dakota
2020-04-04,TN,3321,38070,41391,47,Tennessee
2020-04-04,TX,6110,57641,63751,48,Texas
2020-04-04,UT,1428,26615,28043,49,Utah
2020-04-04,VA,2407,19145,21552,51,Virginia
2020-04-04,VI,40,184,224,78,U.S. Virgin Islands
2020-04-04,VT,512,5242,5754,50,Vermont
2020-04-04,WA,9429,93119,102548,53,Washington
2020-04-04,WI,2112,23859,25971,55,Wisconsin
2020-04-04,WV,282,7404,7686,54,West Virginia
2020-04-04,WY,187,2945,3132,56,Wyoming
2020-04-03,AK,157,5859,6016,02,Alaska
2020-04-03,AL,1432,8187,9619,01,Alabama
2020-04-03,AR,704,8995,9699,05,Arkansas
2020-04-03,AS,0,3,3,60,American Samoa
2020-04-03,AZ,1769,22904,24673,04,Arizona
2020-04-03,CA,10701,24599,35300,06,California
2020-04-03,CO,3728,16683,20411,08,Colorado
2020-04-03,CT,4914,15101,20015,09,Connecticut
2020-04-03,DC,757,4827,5584,11,District of Columbia
2020-04-03,DE,450,4995,5445,10,Delaware
2020-04-03,FL,9585,82137,91722,12,Florida
2020-04-03,GA,5831,19434,25265,13,Georgia
2020-04-03,GU,84,459,543,66,Guam
2020-04-03,HI,285,10206,10491,15,Hawaii
2020-04-03,IA,699,8754,9453,19,Iowa
2020-04-03,ID,891,7054,7945,16,Idaho
2020-04-03,IL,8904,39144,48048,17,Illinois
2020-04-03,IN,3437,14398,17835,18,Indiana
2020-04-03,KS,620,6454,7074,20,Kansas
2020-04-03,KY,770,12034,12804,21,Kentucky
2020-04-03,LA,10297,43348,53645,22,Louisiana
2020-04-03,MA,10303,52685,62988,25,Massachusetts
2020-04-03,MD,2758,20932,23690,24,Maryland
2020-04-03,ME,432,6088,6520,23,Maine
2020-04-03,MI,22579,37060,59639,26,Michigan
2020-04-03,MN,1119,25063,26182,27,Minnesota
2020-04-03,MO,2113,19357,21470,29,Missouri
2020-04-03,MP,8,13,21,69,Northern Mariana Islands
2020-04-03,MS,1358,4753,6111,28,Mississippi
2020-04-03,MT,243,5333,5576,30,Montana
2020-04-03,NC,2093,29505,31598,37,North Carolina
2020-04-03,ND,173,5625,5798,38,North Dakota
2020-04-03,NE,279,4487,4766,31,Nebraska
2020-04-03,NH,479,6575,7054,33,New Hampshire
2020-04-03,NJ,29895,37608,67503,34,New Jersey
2020-04-03,NM,403,14375,14778,35,New Mexico
2020-04-03,NV,1514,13018,14532,32,Nevada
2020-04-03,NY,102863,157657,260520,36,New York
2020-04-03,OH,3312,35063,38375,39,Ohio
2020-04-03,OK,988,1315,2303,40,Oklahoma
2020-04-03,OR,899,16535,17434,41,Oregon
2020-04-03,PA,8420,53695,62115,42,Pennsylvania
2020-04-03,PR,378,2049,2427,72,Puerto Rico
2020-04-03,RI,709,4857,5566,44,Rhode Island
2020-04-03,SC,1554,5441,6995,45,South Carolina
2020-04-03,SD,187,4593,4780,46,South Dakota
2020-04-03,TN,3067,34772,37839,47,Tennessee
2020-04-03,TX,5330,50434,55764,48,Texas
2020-04-03,UT,1246,23002,24248,49,Utah
2020-04-03,VA,2012,16993,19005,51,Virginia
2020-04-03,VI,38,154,192,78,U.S. Virgin Islands
2020-04-03,VT,460,4865,5325,50,Vermont
2020-04-03,WA,9185,90744,99929,53,Washington
2020-04-03,WI,1912,22377,24289,55,Wisconsin
2020-04-03,WV,237,6130,6367,54,West Virginia
2020-04-03,WY,162,2704,2866,56,Wyoming
2020-04-02,AK,143,4879,5022,02,Alaska
2020-04-02,AL,1233,7503,8736,01,Alabama
2020-04-02,AR,643,7880,8523,05,Arkansas
2020-04-02,AS,0,3,3,60,American Samoa
2020-04-02,AZ,1598,21111,22709,04,Arizona
2020-04-02,CA,9191,23809,33000,06,California
2020-04-02,CO,3342,15303,18645,08,Colorado
2020-04-02,CT,3824,14476,18300,09,Connecticut
2020-04-02,DC,653,4417,5070,11,District of Columbia
2020-04-02,DE,393,4566,4959,10,Delaware
2020-04-02,FL,8010,69286,77296,12,Florida
2020-04-02,GA,5348,17609,22957,13,Georgia
2020-04-02,GU,82,442,524,66,Guam
2020-04-02,HI,258,10206,10464,15,Hawaii
2020-04-02,IA,614,8054,8668,19,Iowa
2020-04-02,ID,669,6613,7282,16,Idaho
2020-04-02,IL,7695,35961,43656,17,Illinois
2020-04-02,IN,3039,13246,16285,18,Indiana
2020-04-02,KS,552,6059,6611,20,Kansas
2020-04-02,KY,680,7220,7900,21,Kentucky
2020-04-02,LA,9150,41936,51086,22,Louisiana
2020-04-02,MA,8867,47767,56634,25,Massachusetts
2020-04-02,MD,2331,18890,21221,24,Maryland
2020-04-02,ME,376,6088,6464,23,Maine
2020-04-02,MI,21376,33443,54819,26,Michigan
2020-04-02,MN,1056,23780,24836,27,Minnesota
2020-04-02,MO,1834,17849,19683,29,Missouri
2020-04-02,MP,8,13,21,69,Northern Mariana Islands
2020-04-02,MS,1177,4753,5930,28,Mississippi
2020-04-02,MT,227,5093,5320,30,Montana
2020-04-02,NC,1857,26822,28679,37,North Carolina
2020-04-02,ND,159,4821,4980,38,North Dakota
2020-04-02,NE,246,3978,4224,31,Nebraska
2020-04-02,NH,415,6078,6493,33,New Hampshire
2020-04-02,NJ,25590,33520,59110,34,New Jersey
2020-04-02,NM,363,13648,14011,35,New Mexico
2020-04-02,NV,1458,12588,14046,32,Nevada
2020-04-02,NY,92381,146584,238965,36,New York
2020-04-02,OH,2902,32016,34918,39,Ohio
2020-04-02,OK,879,1265,2144,40,Oklahoma
2020-04-02,OR,826,15259,16085,41,Oregon
2020-04-02,PA,7016,47698,54714,42,Pennsylvania
2020-04-02,PR,316,1604,1920,72,Puerto Rico
2020-04-02,RI,657,4412,5069,44,Rhode Island
2020-04-02,SC,1554,5441,6995,45,South Carolina
2020-04-02,SD,165,4217,4382,46,South Dakota
2020-04-02,TN,2845,31766,34611,47,Tennessee
2020-04-02,TX,4669,46010,50679,48,Texas
2020-04-02,UT,1074,20155,21229,49,Utah
2020-04-02,VA,1706,15883,17589,51,Virginia
2020-04-02,VI,33,149,182,78,U.S. Virgin Islands
2020-04-02,VT,390,4384,4774,50,Vermont
2020-04-02,WA,8904,86170,95074,53,Washington
2020-04-02,WI,1730,20317,22047,55,Wisconsin
2020-04-02,WV,217,5276,5493,54,West Virginia
2020-04-02,WY,150,2439,2589,56,Wyoming
2020-04-01,AK,133,4470,4603,02,Alaska
2020-04-01,AL,1077,6697,7774,01,Alabama
2020-04-01,AR,584,7354,7938,05,Arkansas
2020-04-01,AS,0,3,3,60,American Samoa
2020-04-01,AZ,1413,19645,21058,04,Arizona
2020-04-01,CA,8155,21772,29927,06,California
2020-04-01,CO,2966,13883,16849,08,Colorado
2020-04-01,CT,3557,13043,16600,09,Connecticut
2020-04-01,DC,586,3262,3848,11,District of Columbia
2020-04-01,DE,368,4015,4383,10,Delaware
2020-04-01,FL,6955,59529,66484,12,Florida
2020-04-01,GA,4638,15688,20326,13,Georgia
2020-04-01,GU,77,406,483,66,Guam
2020-04-01,HI,208,8721,8929,15,Hawaii
2020-04-01,IA,549,7304,7853,19,Iowa
2020-04-01,ID,525,6076,6601,16,Idaho
2020-04-01,IL,6980,33404,40384,17,Illinois
2020-04-01,IN,2565,11810,14375,18,Indiana
2020-04-01,KS,482,5411,5893,20,Kansas
2020-04-01,KY,591,6965,7556,21,Kentucky
2020-04-01,LA,6424,39352,45776,22,Louisiana
2020-04-01,MA,7639,44125,51764,25,Massachusetts
2020-04-01,MD,1985,17233,19218,24,Maryland
2020-04-01,ME,344,6088,6432,23,Maine
2020-04-01,MI,20246,29951,50197,26,Michigan
2020-04-01,MN,973,21880,22853,27,Minnesota
2020-04-01,MO,1581,15846,17427,29,Missouri
2020-04-01,MP,6,NA,6,69,Northern Mariana Islands
2020-04-01,MS,1073,3712,4785,28,Mississippi
2020-04-01,MT,208,4710,4918,30,Montana
2020-04-01,NC,1584,24659,26243,37,North Carolina
2020-04-01,ND,142,4351,4493,38,North Dakota
2020-04-01,NE,210,3475,3685,31,Nebraska
2020-04-01,NH,415,5985,6400,33,New Hampshire
2020-04-01,NJ,22255,30387,52642,34,New Jersey
2020-04-01,NM,315,12925,13240,35,New Mexico
2020-04-01,NV,1279,11519,12798,32,Nevada
2020-04-01,NY,83712,137168,220880,36,New York
2020-04-01,OH,2547,26992,29539,39,Ohio
2020-04-01,OK,719,1248,1967,40,Oklahoma
2020-04-01,OR,736,13136,13872,41,Oregon
2020-04-01,PA,5805,42427,48232,42,Pennsylvania
2020-04-01,PR,286,1409,1695,72,Puerto Rico
2020-04-01,RI,566,3831,4397,44,Rhode Island
2020-04-01,SC,1293,5033,6326,45,South Carolina
2020-04-01,SD,129,3903,4032,46,South Dakota
2020-04-01,TN,2683,29769,32452,47,Tennessee
2020-04-01,TX,3997,43860,47857,48,Texas
2020-04-01,UT,1012,20155,21167,49,Utah
2020-04-01,VA,1484,13860,15344,51,Virginia
2020-04-01,VI,30,126,156,78,U.S. Virgin Islands
2020-04-01,VT,359,4162,4521,50,Vermont
2020-04-01,WA,8574,81586,90160,53,Washington
2020-04-01,WI,1550,18819,20369,55,Wisconsin
2020-04-01,WV,191,4384,4575,54,West Virginia
2020-04-01,WY,130,2218,2348,56,Wyoming
2020-03-31,AK,119,3594,3713,02,Alaska
2020-03-31,AL,981,6298,7279,01,Alabama
2020-03-31,AR,523,5959,6482,05,Arkansas
2020-03-31,AS,0,3,3,60,American Samoa
2020-03-31,AZ,1289,18082,19371,04,Arizona
2020-03-31,CA,7482,21772,29254,06,California
2020-03-31,CO,2627,12737,15364,08,Colorado
2020-03-31,CT,3128,13029,16157,09,Connecticut
2020-03-31,DC,495,3262,3757,11,District of Columbia
2020-03-31,DE,319,3696,4015,10,Delaware
2020-03-31,FL,6338,54285,60623,12,Florida
2020-03-31,GA,3929,12252,16181,13,Georgia
2020-03-31,GU,69,371,440,66,Guam
2020-03-31,HI,204,8471,8675,15,Hawaii
2020-03-31,IA,497,6888,7385,19,Iowa
2020-03-31,ID,415,5297,5712,16,Idaho
2020-03-31,IL,5994,29231,35225,17,Illinois
2020-03-31,IN,2159,11214,13373,18,Indiana
2020-03-31,KS,428,4996,5424,20,Kansas
2020-03-31,KY,480,6330,6810,21,Kentucky
2020-03-31,LA,5237,33730,38967,22,Louisiana
2020-03-31,MA,6521,40440,46961,25,Massachusetts
2020-03-31,MD,1660,14868,16528,24,Maryland
2020-03-31,ME,303,6088,6391,23,Maine
2020-03-31,MI,18654,26334,44988,26,Michigan
2020-03-31,MN,916,20935,21851,27,Minnesota
2020-03-31,MO,1327,14614,15941,29,Missouri
2020-03-31,MP,2,NA,2,69,Northern Mariana Islands
2020-03-31,MS,937,3537,4474,28,Mississippi
2020-03-31,MT,184,4234,4418,30,Montana
2020-03-31,NC,1498,21608,23106,37,North Carolina
2020-03-31,ND,126,4131,4257,38,North Dakota
2020-03-31,NE,172,2931,3103,31,Nebraska
2020-03-31,NH,314,5413,5727,33,New Hampshire
2020-03-31,NJ,18696,27077,45773,34,New Jersey
2020-03-31,NM,281,12246,12527,35,New Mexico
2020-03-31,NV,1113,10681,11794,32,Nevada
2020-03-31,NY,75795,129391,205186,36,New York
2020-03-31,OH,2199,26992,29191,39,Ohio
2020-03-31,OK,565,1229,1794,40,Oklahoma
2020-03-31,OR,690,13136,13826,41,Oregon
2020-03-31,PA,4843,37645,42488,42,Pennsylvania
2020-03-31,PR,239,1195,1434,72,Puerto Rico
2020-03-31,RI,489,3476,3965,44,Rhode Island
2020-03-31,SC,1083,4616,5699,45,South Carolina
2020-03-31,SD,108,3609,3717,46,South Dakota
2020-03-31,TN,2239,25121,27360,47,Tennessee
2020-03-31,TX,3266,39726,42992,48,Texas
2020-03-31,UT,887,17626,18513,49,Utah
2020-03-31,VA,1250,12151,13401,51,Virginia
2020-03-31,VI,30,126,156,78,U.S. Virgin Islands
2020-03-31,VT,320,3949,4269,50,Vermont
2020-03-31,WA,8138,77320,85458,53,Washington
2020-03-31,WI,1351,17375,18726,55,Wisconsin
2020-03-31,WV,162,3981,4143,54,West Virginia
2020-03-31,WY,109,1999,2108,56,Wyoming
2020-03-30,AK,114,3540,3654,02,Alaska
2020-03-30,AL,859,5694,6553,01,Alabama
2020-03-30,AR,473,5262,5735,05,Arkansas
2020-03-30,AS,NA,NA,0,60,American Samoa
2020-03-30,AZ,1157,15602,16759,04,Arizona
2020-03-30,CA,6447,20549,26996,06,California
2020-03-30,CO,2627,12737,15364,08,Colorado
2020-03-30,CT,2571,12029,14600,09,Connecticut
2020-03-30,DC,401,2682,3083,11,District of Columbia
2020-03-30,DE,264,2216,2480,10,Delaware
2020-03-30,FL,5473,48225,53698,12,Florida
2020-03-30,GA,2809,9915,12724,13,Georgia
2020-03-30,GU,58,352,410,66,Guam
2020-03-30,HI,175,7825,8000,15,Hawaii
2020-03-30,IA,424,6162,6586,19,Iowa
2020-03-30,ID,310,4396,4706,16,Idaho
2020-03-30,IL,5057,25389,30446,17,Illinois
2020-03-30,IN,1786,9872,11658,18,Indiana
2020-03-30,KS,368,4554,4922,20,Kansas
2020-03-30,KY,439,5579,6018,21,Kentucky
2020-03-30,LA,4025,30008,34033,22,Louisiana
2020-03-30,MA,5653,37166,42819,25,Massachusetts
2020-03-30,MD,1413,13316,14729,24,Maryland
2020-03-30,ME,275,3394,3669,23,Maine
2020-03-30,MI,17363,23263,40626,26,Michigan
2020-03-30,MN,823,19512,20335,27,Minnesota
2020-03-30,MO,1031,13204,14235,29,Missouri
2020-03-30,MP,2,NA,2,69,Northern Mariana Islands
2020-03-30,MS,847,2989,3836,28,Mississippi
2020-03-30,MT,171,4143,4314,30,Montana
2020-03-30,NC,1307,19557,20864,37,North Carolina
2020-03-30,ND,109,3728,3837,38,North Dakota
2020-03-30,NE,145,2584,2729,31,Nebraska
2020-03-30,NH,314,5386,5700,33,New Hampshire
2020-03-30,NJ,16636,25224,41860,34,New Jersey
2020-03-30,NM,237,10942,11179,35,New Mexico
2020-03-30,NV,1008,10207,11215,32,Nevada
2020-03-30,NY,66497,119971,186468,36,New York
2020-03-30,OH,1933,25342,27275,39,Ohio
2020-03-30,OK,481,1207,1688,40,Oklahoma
2020-03-30,OR,606,12277,12883,41,Oregon
2020-03-30,PA,4087,33777,37864,42,Pennsylvania
2020-03-30,PR,174,931,1105,72,Puerto Rico
2020-03-30,RI,402,3187,3589,44,Rhode Island
2020-03-30,SC,925,4160,5085,45,South Carolina
2020-03-30,SD,101,3478,3579,46,South Dakota
2020-03-30,TN,1834,21470,23304,47,Tennessee
2020-03-30,TX,2877,33003,35880,48,Texas
2020-03-30,UT,806,15197,16003,49,Utah
2020-03-30,VA,1020,11018,12038,51,Virginia
2020-03-30,VI,30,126,156,78,U.S. Virgin Islands
2020-03-30,VT,293,3718,4011,50,Vermont
2020-03-30,WA,7831,72902,80733,53,Washington
2020-03-30,WI,1221,15856,17077,55,Wisconsin
2020-03-30,WV,126,2984,3110,54,West Virginia
2020-03-30,WY,94,1840,1934,56,Wyoming
2020-03-29,AK,102,3232,3334,02,Alaska
2020-03-29,AL,806,4184,4990,01,Alabama
2020-03-29,AR,426,3027,3453,05,Arkansas
2020-03-29,AS,NA,NA,0,60,American Samoa
2020-03-29,AZ,919,12953,13872,04,Arizona
2020-03-29,CA,5708,20549,26257,06,California
2020-03-29,CO,2061,11215,13276,08,Colorado
2020-03-29,CT,1993,9907,11900,09,Connecticut
2020-03-29,DC,342,2469,2811,11,District of Columbia
2020-03-29,DE,232,36,268,10,Delaware
2020-03-29,FL,4246,39070,43316,12,Florida
2020-03-29,GA,2651,9913,12564,13,Georgia
2020-03-29,GU,56,334,390,66,Guam
2020-03-29,HI,151,6849,7000,15,Hawaii
2020-03-29,IA,336,5013,5349,19,Iowa
2020-03-29,ID,261,4021,4282,16,Idaho
2020-03-29,IL,4596,23166,27762,17,Illinois
2020-03-29,IN,1514,8316,9830,18,Indiana
2020-03-29,KS,319,4194,4513,20,Kansas
2020-03-29,KY,394,5147,5541,21,Kentucky
2020-03-29,LA,3540,24331,27871,22,Louisiana
2020-03-29,MA,4856,34234,39090,25,Massachusetts
2020-03-29,MD,1239,12354,13593,24,Maryland
2020-03-29,ME,253,3394,3647,23,Maine
2020-03-29,MI,15784,17417,33201,26,Michigan
2020-03-29,MN,725,18566,19291,27,Minnesota
2020-03-29,MO,838,11547,12385,29,Missouri
2020-03-29,MP,2,NA,2,69,Northern Mariana Islands
2020-03-29,MS,758,2560,3318,28,Mississippi
2020-03-29,MT,154,4143,4297,30,Montana
2020-03-29,NC,1040,17905,18945,37,North Carolina
2020-03-29,ND,98,3355,3453,38,North Dakota
2020-03-29,NE,108,1968,2076,31,Nebraska
2020-03-29,NH,214,4524,4738,33,New Hampshire
2020-03-29,NJ,13386,22216,35602,34,New Jersey
2020-03-29,NM,237,10769,11006,35,New Mexico
2020-03-29,NV,738,8412,9150,32,Nevada
2020-03-29,NY,59513,112847,172360,36,New York
2020-03-29,OH,1653,19012,20665,39,Ohio
2020-03-29,OK,429,1205,1634,40,Oklahoma
2020-03-29,OR,548,10878,11426,41,Oregon
2020-03-29,PA,3394,30061,33455,42,Pennsylvania
2020-03-29,PR,127,841,968,72,Puerto Rico
2020-03-29,RI,294,2840,3134,44,Rhode Island
2020-03-29,SC,774,3015,3789,45,South Carolina
2020-03-29,SD,90,3127,3217,46,South Dakota
2020-03-29,TN,1537,19037,20574,47,Tennessee
2020-03-29,TX,2552,23208,25760,48,Texas
2020-03-29,UT,719,13274,13993,49,Utah
2020-03-29,VA,890,9719,10609,51,Virginia
2020-03-29,VI,23,123,146,78,U.S. Virgin Islands
2020-03-29,VT,256,3483,3739,50,Vermont
2020-03-29,WA,7429,68150,75579,53,Washington
2020-03-29,WI,1112,16550,17662,55,Wisconsin
2020-03-29,WV,113,2705,2818,54,West Virginia
2020-03-29,WY,86,1554,1640,56,Wyoming
2020-03-28,AK,85,2836,2921,02,Alaska
2020-03-28,AL,696,4184,4880,01,Alabama
2020-03-28,AR,404,2938,3342,05,Arkansas
2020-03-28,AS,NA,NA,0,60,American Samoa
2020-03-28,AZ,873,7455,8328,04,Arizona
2020-03-28,CA,4643,20549,25192,06,California
2020-03-28,CO,1734,9942,11676,08,Colorado
2020-03-28,CT,1291,7109,8400,09,Connecticut
2020-03-28,DC,304,2211,2515,11,District of Columbia
2020-03-28,DE,214,36,250,10,Delaware
2020-03-28,FL,3763,35366,39129,12,Florida
2020-03-28,GA,2366,8685,11051,13,Georgia
2020-03-28,GU,55,299,354,66,Guam
2020-03-28,HI,120,4357,4477,15,Hawaii
2020-03-28,IA,298,4375,4673,19,Iowa
2020-03-28,ID,230,3342,3572,16,Idaho
2020-03-28,IL,3491,22000,25491,17,Illinois
2020-03-28,IN,1232,7175,8407,18,Indiana
2020-03-28,KS,261,3671,3932,20,Kansas
2020-03-28,KY,302,4821,5123,21,Kentucky
2020-03-28,LA,3315,21846,25161,22,Louisiana
2020-03-28,MA,4158,30915,35073,25,Massachusetts
2020-03-28,MD,992,11516,12508,24,Maryland
2020-03-28,ME,211,3394,3605,23,Maine
2020-03-28,MI,14865,15902,30767,26,Michigan
2020-03-28,MN,687,17395,18082,27,Minnesota
2020-03-28,MO,838,10082,10920,29,Missouri
2020-03-28,MP,2,NA,2,69,Northern Mariana Islands
2020-03-28,MS,663,2560,3223,28,Mississippi
2020-03-28,MT,129,3256,3385,30,Montana
2020-03-28,NC,935,16592,17527,37,North Carolina
2020-03-28,ND,83,2809,2892,38,North Dakota
2020-03-28,NE,96,1904,2000,31,Nebraska
2020-03-28,NH,187,3656,3843,33,New Hampshire
2020-03-28,NJ,11124,19386,30510,34,New Jersey
2020-03-28,NM,191,9196,9387,35,New Mexico
2020-03-28,NV,621,7901,8522,32,Nevada
2020-03-28,NY,52318,103616,155934,36,New York
2020-03-28,OH,1406,19012,20418,39,Ohio
2020-03-28,OK,377,1180,1557,40,Oklahoma
2020-03-28,OR,479,9693,10172,41,Oregon
2020-03-28,PA,2751,25254,28005,42,Pennsylvania
2020-03-28,PR,100,739,839,72,Puerto Rico
2020-03-28,RI,239,2541,2780,44,Rhode Island
2020-03-28,SC,539,2408,2947,45,South Carolina
2020-03-28,SD,68,2592,2660,46,South Dakota
2020-03-28,TN,1373,16965,18338,47,Tennessee
2020-03-28,TX,2052,23208,25260,48,Texas
2020-03-28,UT,602,10710,11312,49,Utah
2020-03-28,VA,739,8427,9166,51,Virginia
2020-03-28,VI,22,106,128,78,U.S. Virgin Islands
2020-03-28,VT,234,3192,3426,50,Vermont
2020-03-28,WA,7112,66631,73743,53,Washington
2020-03-28,WI,989,15232,16221,55,Wisconsin
2020-03-28,WV,96,2331,2427,54,West Virginia
2020-03-28,WY,82,1475,1557,56,Wyoming
2020-03-27,AK,69,2319,2388,02,Alaska
2020-03-27,AL,587,4184,4771,01,Alabama
2020-03-27,AR,381,1545,1926,05,Arkansas
2020-03-27,AS,NA,NA,0,60,American Samoa
2020-03-27,AZ,736,7455,8191,04,Arizona
2020-03-27,CA,3879,17380,21259,06,California
2020-03-27,CO,1430,8692,10122,08,Colorado
2020-03-27,CT,1291,7109,8400,09,Connecticut
2020-03-27,DC,267,1897,2164,11,District of Columbia
2020-03-27,DE,163,36,199,10,Delaware
2020-03-27,FL,2765,28186,30951,12,Florida
2020-03-27,GA,2001,7864,9865,13,Georgia
2020-03-27,GU,51,299,350,66,Guam
2020-03-27,HI,106,4357,4463,15,Hawaii
2020-03-27,IA,235,3740,3975,19,Iowa
2020-03-27,ID,189,2668,2857,16,Idaho
2020-03-27,IL,3026,18516,21542,17,Illinois
2020-03-27,IN,981,5955,6936,18,Indiana
2020-03-27,KS,202,3229,3431,20,Kansas
2020-03-27,KY,248,3768,4016,21,Kentucky
2020-03-27,LA,2746,18613,21359,22,Louisiana
2020-03-27,MA,3151,26244,29395,25,Massachusetts
2020-03-27,MD,774,94,868,24,Maryland
2020-03-27,ME,168,3394,3562,23,Maine
2020-03-27,MI,13799,14140,27939,26,Michigan
2020-03-27,MN,640,13605,14245,27,Minnesota
2020-03-27,MO,669,369,1038,29,Missouri
2020-03-27,MP,0,NA,0,69,Northern Mariana Islands
2020-03-27,MS,579,2560,3139,28,Mississippi
2020-03-27,MT,108,2590,2698,30,Montana
2020-03-27,NC,763,14373,15136,37,North Carolina
2020-03-27,ND,65,2427,2492,38,North Dakota
2020-03-27,NE,85,1761,1846,31,Nebraska
2020-03-27,NH,158,3395,3553,33,New Hampshire
2020-03-27,NJ,8825,16547,25372,34,New Jersey
2020-03-27,NM,136,8377,8513,35,New Mexico
2020-03-27,NV,535,6161,6696,32,Nevada
2020-03-27,NY,44635,101118,145753,36,New York
2020-03-27,OH,1137,19012,20149,39,Ohio
2020-03-27,OK,322,1084,1406,40,Oklahoma
2020-03-27,OR,414,8510,8924,41,Oregon
2020-03-27,PA,2218,21016,23234,42,Pennsylvania
2020-03-27,PR,79,519,598,72,Puerto Rico
2020-03-27,RI,203,2306,2509,44,Rhode Island
2020-03-27,SC,456,2307,2763,45,South Carolina
2020-03-27,SD,58,2387,2445,46,South Dakota
2020-03-27,TN,1203,14888,16091,47,Tennessee
2020-03-27,TX,1731,21935,23666,48,Texas
2020-03-27,UT,480,8764,9244,49,Utah
2020-03-27,VA,604,6733,7337,51,Virginia
2020-03-27,VI,19,55,74,78,U.S. Virgin Islands
2020-03-27,VT,213,2868,3081,50,Vermont
2020-03-27,WA,6791,64348,71139,53,Washington
2020-03-27,WI,842,13140,13982,55,Wisconsin
2020-03-27,WV,76,1779,1855,54,West Virginia
2020-03-27,WY,70,1211,1281,56,Wyoming
2020-03-26,AK,59,1801,1860,02,Alaska
2020-03-26,AL,506,3593,4099,01,Alabama
2020-03-26,AR,335,1504,1839,05,Arkansas
2020-03-26,AS,NA,NA,0,60,American Samoa
2020-03-26,AZ,577,347,924,04,Arizona
2020-03-26,CA,3006,17380,20386,06,California
2020-03-26,CO,1086,6978,8064,08,Colorado
2020-03-26,CT,1012,5625,6637,09,Connecticut
2020-03-26,DC,231,1626,1857,11,District of Columbia
2020-03-26,DE,130,36,166,10,Delaware
2020-03-26,FL,2355,23741,26096,12,Florida
2020-03-26,GA,1525,7401,8926,13,Georgia
2020-03-26,GU,45,263,308,66,Guam
2020-03-26,HI,95,4357,4452,15,Hawaii
2020-03-26,IA,179,2578,2757,19,Iowa
2020-03-26,ID,123,2065,2188,16,Idaho
2020-03-26,IL,2538,14093,16631,17,Illinois
2020-03-26,IN,645,4006,4651,18,Indiana
2020-03-26,KS,168,2869,3037,20,Kansas
2020-03-26,KY,198,3102,3300,21,Kentucky
2020-03-26,LA,2305,15724,18029,22,Louisiana
2020-03-26,MA,2318,21327,23645,25,Massachusetts
2020-03-26,MD,580,94,674,24,Maryland
2020-03-26,ME,155,3394,3549,23,Maine
2020-03-26,MI,12475,11730,24205,26,Michigan
2020-03-26,MN,565,12604,13169,27,Minnesota
2020-03-26,MO,502,369,871,29,Missouri
2020-03-26,MP,0,NA,0,69,Northern Mariana Islands
2020-03-26,MS,485,2291,2776,28,Mississippi
2020-03-26,MT,71,2128,2199,30,Montana
2020-03-26,NC,636,12274,12910,37,North Carolina
2020-03-26,ND,52,2039,2091,38,North Dakota
2020-03-26,NE,73,1584,1657,31,Nebraska
2020-03-26,NH,137,3001,3138,33,New Hampshire
2020-03-26,NJ,6876,13661,20537,34,New Jersey
2020-03-26,NM,112,7681,7793,35,New Mexico
2020-03-26,NV,420,4697,5117,32,Nevada
2020-03-26,NY,37258,84846,122104,36,New York
2020-03-26,OH,867,16449,17316,39,Ohio
2020-03-26,OK,248,958,1206,40,Oklahoma
2020-03-26,OR,327,6953,7280,41,Oregon
2020-03-26,PA,1687,16441,18128,42,Pennsylvania
2020-03-26,PR,64,377,441,72,Puerto Rico
2020-03-26,RI,165,1262,1427,44,Rhode Island
2020-03-26,SC,456,2307,2763,45,South Carolina
2020-03-26,SD,46,1973,2019,46,South Dakota
2020-03-26,TN,957,13952,14909,47,Tennessee
2020-03-26,TX,1396,20028,21424,48,Texas
2020-03-26,UT,402,7308,7710,49,Utah
2020-03-26,VA,460,5729,6189,51,Virginia
2020-03-26,VI,17,55,72,78,U.S. Virgin Islands
2020-03-26,VT,185,2744,2929,50,Vermont
2020-03-26,WA,6414,60367,66781,53,Washington
2020-03-26,WI,707,11583,12290,55,Wisconsin
2020-03-26,WV,51,1031,1082,54,West Virginia
2020-03-26,WY,53,1052,1105,56,Wyoming
2020-03-25,AK,42,1649,1691,02,Alaska
2020-03-25,AL,283,2529,2812,01,Alabama
2020-03-25,AR,280,1437,1717,05,Arkansas
2020-03-25,AS,NA,NA,0,60,American Samoa
2020-03-25,AZ,450,323,773,04,Arizona
2020-03-25,CA,2355,15921,18276,06,California
2020-03-25,CO,912,6789,7701,08,Colorado
2020-03-25,CT,875,5023,5898,09,Connecticut
2020-03-25,DC,183,1423,1606,11,District of Columbia
2020-03-25,DE,115,36,151,10,Delaware
2020-03-25,FL,1682,15374,17056,12,Florida
2020-03-25,GA,1247,4932,6179,13,Georgia
2020-03-25,GU,37,233,270,66,Guam
2020-03-25,HI,90,4357,4447,15,Hawaii
2020-03-25,IA,145,2578,2723,19,Iowa
2020-03-25,ID,73,1887,1960,16,Idaho
2020-03-25,IL,1865,12344,14209,17,Illinois
2020-03-25,IN,477,2879,3356,18,Indiana
2020-03-25,KS,126,2360,2486,20,Kansas
2020-03-25,KY,157,2865,3022,21,Kentucky
2020-03-25,LA,1795,9656,11451,22,Louisiana
2020-03-25,MA,1739,18079,19818,25,Massachusetts
2020-03-25,MD,423,94,517,24,Maryland
2020-03-25,ME,149,3177,3326,23,Maine
2020-03-25,MI,11335,8842,20177,26,Michigan
2020-03-25,MN,502,11188,11690,27,Minnesota
2020-03-25,MO,356,369,725,29,Missouri
2020-03-25,MP,0,NA,0,69,Northern Mariana Islands
2020-03-25,MS,377,1566,1943,28,Mississippi
2020-03-25,MT,53,1948,2001,30,Montana
2020-03-25,NC,504,9985,10489,37,North Carolina
2020-03-25,ND,39,1734,1773,38,North Dakota
2020-03-25,NE,61,1304,1365,31,Nebraska
2020-03-25,NH,108,2356,2464,33,New Hampshire
2020-03-25,NJ,4402,10452,14854,34,New Jersey
2020-03-25,NM,100,6742,6842,35,New Mexico
2020-03-25,NV,321,4251,4572,32,Nevada
2020-03-25,NY,30811,72668,103479,36,New York
2020-03-25,OH,704,14060,14764,39,Ohio
2020-03-25,OK,164,805,969,40,Oklahoma
2020-03-25,OR,209,4350,4559,41,Oregon
2020-03-25,PA,1127,11193,12320,42,Pennsylvania
2020-03-25,PR,51,317,368,72,Puerto Rico
2020-03-25,RI,132,1262,1394,44,Rhode Island
2020-03-25,SC,424,2303,2727,45,South Carolina
2020-03-25,SD,41,819,860,46,South Dakota
2020-03-25,TN,784,11012,11796,47,Tennessee
2020-03-25,TX,974,12520,13494,48,Texas
2020-03-25,UT,346,6491,6837,49,Utah
2020-03-25,VA,391,4979,5370,51,Virginia
2020-03-25,VI,17,55,72,78,U.S. Virgin Islands
2020-03-25,VT,160,1810,1970,50,Vermont
2020-03-25,WA,6045,56261,62306,53,Washington
2020-03-25,WI,585,10089,10674,55,Wisconsin
2020-03-25,WV,39,759,798,54,West Virginia
2020-03-25,WY,44,954,998,56,Wyoming
2020-03-24,AK,36,986,1022,02,Alaska
2020-03-24,AL,215,2106,2321,01,Alabama
2020-03-24,AR,218,947,1165,05,Arkansas
2020-03-24,AS,NA,NA,0,60,American Samoa
2020-03-24,AZ,357,313,670,04,Arizona
2020-03-24,CA,2102,13452,15554,06,California
2020-03-24,CO,720,5504,6224,08,Colorado
2020-03-24,CT,618,4682,5300,09,Connecticut
2020-03-24,DC,137,1195,1332,11,District of Columbia
2020-03-24,DE,91,36,127,10,Delaware
2020-03-24,FL,1412,13127,14539,12,Florida
2020-03-24,GA,1026,4458,5484,13,Georgia
2020-03-24,GU,32,201,233,66,Guam
2020-03-24,HI,77,3589,3666,15,Hawaii
2020-03-24,IA,124,2315,2439,19,Iowa
2020-03-24,ID,50,1887,1937,16,Idaho
2020-03-24,IL,1535,9934,11469,17,Illinois
2020-03-24,IN,365,2566,2931,18,Indiana
2020-03-24,KS,98,2086,2184,20,Kansas
2020-03-24,KY,124,1762,1886,21,Kentucky
2020-03-24,LA,1388,7215,8603,22,Louisiana
2020-03-24,MA,1060,12714,13774,25,Massachusetts
2020-03-24,MD,349,94,443,24,Maryland
2020-03-24,ME,125,3014,3139,23,Maine
2020-03-24,MI,10155,6989,17144,26,Michigan
2020-03-24,MN,444,5550,5994,27,Minnesota
2020-03-24,MO,183,369,552,29,Missouri
2020-03-24,MP,0,NA,0,69,Northern Mariana Islands
2020-03-24,MS,320,1552,1872,28,Mississippi
2020-03-24,MT,46,1643,1689,30,Montana
2020-03-24,NC,398,8141,8539,37,North Carolina
2020-03-24,ND,34,1454,1488,38,North Dakota
2020-03-24,NE,52,975,1027,31,Nebraska
2020-03-24,NH,101,1447,1548,33,New Hampshire
2020-03-24,NJ,3675,8325,12000,34,New Jersey
2020-03-24,NM,83,5890,5973,35,New Mexico
2020-03-24,NV,278,3954,4232,32,Nevada
2020-03-24,NY,25665,65605,91270,36,New York
2020-03-24,OH,564,140,704,39,Ohio
2020-03-24,OK,106,735,841,40,Oklahoma
2020-03-24,OR,209,4350,4559,41,Oregon
2020-03-24,PA,851,8643,9494,42,Pennsylvania
2020-03-24,PR,39,268,307,72,Puerto Rico
2020-03-24,RI,124,1200,1324,44,Rhode Island
2020-03-24,SC,298,2012,2310,45,South Carolina
2020-03-24,SD,30,790,820,46,South Dakota
2020-03-24,TN,667,10517,11184,47,Tennessee
2020-03-24,TX,410,10757,11167,48,Texas
2020-03-24,UT,299,5524,5823,49,Utah
2020-03-24,VA,290,4180,4470,51,Virginia
2020-03-24,VI,17,NA,17,78,U.S. Virgin Islands
2020-03-24,VT,125,1569,1694,50,Vermont
2020-03-24,WA,5640,51665,57305,53,Washington
2020-03-24,WI,457,8237,8694,55,Wisconsin
2020-03-24,WV,20,610,630,54,West Virginia
2020-03-24,WY,29,710,739,56,Wyoming
2020-03-23,AK,22,946,968,02,Alaska
2020-03-23,AL,167,1665,1832,01,Alabama
2020-03-23,AR,174,906,1080,05,Arkansas
2020-03-23,AS,NA,NA,0,60,American Samoa
2020-03-23,AZ,265,309,574,04,Arizona
2020-03-23,CA,1733,12567,14300,06,California
2020-03-23,CO,591,4845,5436,08,Colorado
2020-03-23,CT,415,4085,4500,09,Connecticut
2020-03-23,DC,116,1113,1229,11,District of Columbia
2020-03-23,DE,68,36,104,10,Delaware
2020-03-23,FL,1171,11063,12234,12,Florida
2020-03-23,GA,772,4297,5069,13,Georgia
2020-03-23,GU,29,161,190,66,Guam
2020-03-23,HI,56,2955,3011,15,Hawaii
2020-03-23,IA,105,2043,2148,19,Iowa
2020-03-23,ID,47,1309,1356,16,Idaho
2020-03-23,IL,1273,8583,9856,17,Illinois
2020-03-23,IN,259,1701,1960,18,Indiana
2020-03-23,KS,82,417,499,20,Kansas
2020-03-23,KY,104,1762,1866,21,Kentucky
2020-03-23,LA,1172,4776,5948,22,Louisiana
2020-03-23,MA,678,8263,8941,25,Massachusetts
2020-03-23,MD,288,94,382,24,Maryland
2020-03-23,ME,107,2791,2898,23,Maine
2020-03-23,MI,9062,5847,14909,26,Michigan
2020-03-23,MN,393,4511,4904,27,Minnesota
2020-03-23,MO,183,369,552,29,Missouri
2020-03-23,MP,0,NA,0,69,Northern Mariana Islands
2020-03-23,MS,249,1143,1392,28,Mississippi
2020-03-23,MT,34,1146,1180,30,Montana
2020-03-23,NC,297,8141,8438,37,North Carolina
2020-03-23,ND,30,1353,1383,38,North Dakota
2020-03-23,NE,50,356,406,31,Nebraska
2020-03-23,NH,78,1374,1452,33,New Hampshire
2020-03-23,NJ,2844,359,3203,34,New Jersey
2020-03-23,NM,65,5321,5386,35,New Mexico
2020-03-23,NV,245,3490,3735,32,Nevada
2020-03-23,NY,20875,57414,78289,36,New York
2020-03-23,OH,442,140,582,39,Ohio
2020-03-23,OK,81,694,775,40,Oklahoma
2020-03-23,OR,191,3649,3840,41,Oregon
2020-03-23,PA,644,6595,7239,42,Pennsylvania
2020-03-23,PR,31,189,220,72,Puerto Rico
2020-03-23,RI,106,1143,1249,44,Rhode Island
2020-03-23,SC,298,1466,1764,45,South Carolina
2020-03-23,SD,28,762,790,46,South Dakota
2020-03-23,TN,615,3272,3887,47,Tennessee
2020-03-23,TX,352,9703,10055,48,Texas
2020-03-23,UT,257,4790,5047,49,Utah
2020-03-23,VA,254,3443,3697,51,Virginia
2020-03-23,VI,17,NA,17,78,U.S. Virgin Islands
2020-03-23,VT,97,1424,1521,50,Vermont
2020-03-23,WA,5286,46773,52059,53,Washington
2020-03-23,WI,416,7050,7466,55,Wisconsin
2020-03-23,WV,16,444,460,54,West Virginia
2020-03-23,WY,26,592,618,56,Wyoming
2020-03-22,AK,22,946,968,02,Alaska
2020-03-22,AL,138,1464,1602,01,Alabama
2020-03-22,AR,165,711,876,05,Arkansas
2020-03-22,AS,NA,NA,0,60,American Samoa
2020-03-22,AZ,152,282,434,04,Arizona
2020-03-22,CA,1536,11304,12840,06,California
2020-03-22,CO,475,4075,4550,08,Colorado
2020-03-22,CT,223,2877,3100,09,Connecticut
2020-03-22,DC,98,957,1055,11,District of Columbia
2020-03-22,DE,56,36,92,10,Delaware
2020-03-22,FL,830,7990,8820,12,Florida
2020-03-22,GA,600,3420,4020,13,Georgia
2020-03-22,GU,27,126,153,66,Guam
2020-03-22,HI,48,263,311,15,Hawaii
2020-03-22,IA,90,1215,1305,19,Iowa
2020-03-22,ID,42,1175,1217,16,Idaho
2020-03-22,IL,1049,7271,8320,17,Illinois
2020-03-22,IN,201,1293,1494,18,Indiana
2020-03-22,KS,64,417,481,20,Kansas
2020-03-22,KY,99,1472,1571,21,Kentucky
2020-03-22,LA,837,2661,3498,22,Louisiana
2020-03-22,MA,547,5476,6023,25,Massachusetts
2020-03-22,MD,244,94,338,24,Maryland
2020-03-22,ME,89,2264,2353,23,Maine
2020-03-22,MI,7822,4791,12613,26,Michigan
2020-03-22,MN,349,4511,4860,27,Minnesota
2020-03-22,MO,90,369,459,29,Missouri
2020-03-22,MP,0,NA,0,69,Northern Mariana Islands
2020-03-22,MS,207,1114,1321,28,Mississippi
2020-03-22,MT,31,1146,1177,30,Montana
2020-03-22,NC,255,6183,6438,37,North Carolina
2020-03-22,ND,28,1260,1288,38,North Dakota
2020-03-22,NE,48,356,404,31,Nebraska
2020-03-22,NH,65,1188,1253,33,New Hampshire
2020-03-22,NJ,1914,327,2241,34,New Jersey
2020-03-22,NM,57,4722,4779,35,New Mexico
2020-03-22,NV,190,2448,2638,32,Nevada
2020-03-22,NY,15168,46233,61401,36,New York
2020-03-22,OH,351,140,491,39,Ohio
2020-03-22,OK,67,669,736,40,Oklahoma
2020-03-22,OR,161,2864,3025,41,Oregon
2020-03-22,PA,479,4964,5443,42,Pennsylvania
2020-03-22,PR,23,183,206,72,Puerto Rico
2020-03-22,RI,83,932,1015,44,Rhode Island
2020-03-22,SC,195,1466,1661,45,South Carolina
2020-03-22,SD,21,740,761,46,South Dakota
2020-03-22,TN,505,3272,3777,47,Tennessee
2020-03-22,TX,334,8422,8756,48,Texas
2020-03-22,UT,181,3508,3689,49,Utah
2020-03-22,VA,219,3118,3337,51,Virginia
2020-03-22,VI,6,NA,6,78,U.S. Virgin Islands
2020-03-22,VT,76,1204,1280,50,Vermont
2020-03-22,WA,4838,41916,46754,53,Washington
2020-03-22,WI,385,6230,6615,55,Wisconsin
2020-03-22,WV,12,385,397,54,West Virginia
2020-03-22,WY,24,438,462,56,Wyoming
2020-03-21,AK,14,758,772,02,Alaska
2020-03-21,AL,124,28,152,01,Alabama
2020-03-21,AR,118,567,685,05,Arkansas
2020-03-21,AS,NA,NA,0,60,American Samoa
2020-03-21,AZ,104,240,344,04,Arizona
2020-03-21,CA,1279,11249,12528,06,California
2020-03-21,CO,363,3317,3680,08,Colorado
2020-03-21,CT,194,2106,2300,09,Connecticut
2020-03-21,DC,77,506,583,11,District of Columbia
2020-03-21,DE,45,36,81,10,Delaware
2020-03-21,FL,658,6579,7237,12,Florida
2020-03-21,GA,507,2557,3064,13,Georgia
2020-03-21,GU,15,108,123,66,Guam
2020-03-21,HI,37,124,161,15,Hawaii
2020-03-21,IA,68,1049,1117,19,Iowa
2020-03-21,ID,31,880,911,16,Idaho
2020-03-21,IL,753,5488,6241,17,Illinois
2020-03-21,IN,126,707,833,18,Indiana
2020-03-21,KS,55,417,472,20,Kansas
2020-03-21,KY,54,714,768,21,Kentucky
2020-03-21,LA,580,2180,2760,22,Louisiana
2020-03-21,MA,426,4799,5225,25,Massachusetts
2020-03-21,MD,190,94,284,24,Maryland
2020-03-21,ME,73,2264,2337,23,Maine
2020-03-21,MI,7023,4086,11109,26,Michigan
2020-03-21,MN,327,3952,4279,27,Minnesota
2020-03-21,MO,73,369,442,29,Missouri
2020-03-21,MP,0,NA,0,69,Northern Mariana Islands
2020-03-21,MS,140,695,835,28,Mississippi
2020-03-21,MT,20,1146,1166,30,Montana
2020-03-21,NC,184,5092,5276,37,North Carolina
2020-03-21,ND,28,1141,1169,38,North Dakota
2020-03-21,NE,38,356,394,31,Nebraska
2020-03-21,NH,55,973,1028,33,New Hampshire
2020-03-21,NJ,1327,294,1621,34,New Jersey
2020-03-21,NM,57,3771,3828,35,New Mexico
2020-03-21,NV,124,2384,2508,32,Nevada
2020-03-21,NY,10356,35081,45437,36,New York
2020-03-21,OH,247,140,387,39,Ohio
2020-03-21,OK,53,560,613,40,Oklahoma
2020-03-21,OR,114,2003,2117,41,Oregon
2020-03-21,PA,371,3766,4137,42,Pennsylvania
2020-03-21,PR,21,143,164,72,Puerto Rico
2020-03-21,RI,66,862,928,44,Rhode Island
2020-03-21,SC,152,1255,1407,45,South Carolina
2020-03-21,SD,14,691,705,46,South Dakota
2020-03-21,TN,371,3272,3643,47,Tennessee
2020-03-21,TX,304,6218,6522,48,Texas
2020-03-21,UT,136,2424,2560,49,Utah
2020-03-21,VA,152,2638,2790,51,Virginia
2020-03-21,VI,6,NA,6,78,U.S. Virgin Islands
2020-03-21,VT,52,1080,1132,50,Vermont
2020-03-21,WA,4555,40311,44866,53,Washington
2020-03-21,WI,281,4628,4909,55,Wisconsin
2020-03-21,WV,11,330,341,54,West Virginia
2020-03-21,WY,23,438,461,56,Wyoming
2020-03-20,AK,12,686,698,02,Alaska
2020-03-20,AL,81,28,109,01,Alabama
2020-03-20,AR,96,351,447,05,Arkansas
2020-03-20,AS,NA,NA,0,60,American Samoa
2020-03-20,AZ,65,211,276,04,Arizona
2020-03-20,CA,1063,10424,11487,06,California
2020-03-20,CO,277,2675,2952,08,Colorado
2020-03-20,CT,194,604,798,09,Connecticut
2020-03-20,DC,71,501,572,11,District of Columbia
2020-03-20,DE,38,36,74,10,Delaware
2020-03-20,FL,520,1870,2390,12,Florida
2020-03-20,GA,420,1966,2386,13,Georgia
2020-03-20,GU,14,86,100,66,Guam
2020-03-20,HI,26,124,150,15,Hawaii
2020-03-20,IA,45,642,687,19,Iowa
2020-03-20,ID,23,590,613,16,Idaho
2020-03-20,IL,585,3696,4281,17,Illinois
2020-03-20,IN,79,475,554,18,Indiana
2020-03-20,KS,44,417,461,20,Kansas
2020-03-20,KY,47,592,639,21,Kentucky
2020-03-20,LA,473,568,1041,22,Louisiana
2020-03-20,MA,314,3795,4109,25,Massachusetts
2020-03-20,MD,149,94,243,24,Maryland
2020-03-20,ME,57,2264,2321,23,Maine
2020-03-20,MI,6219,3041,9260,26,Michigan
2020-03-20,MN,303,3741,4044,27,Minnesota
2020-03-20,MO,47,369,416,29,Missouri
2020-03-20,MP,0,NA,0,69,Northern Mariana Islands
2020-03-20,MS,80,695,775,28,Mississippi
2020-03-20,MT,16,931,947,30,Montana
2020-03-20,NC,137,3096,3233,37,North Carolina
2020-03-20,ND,20,800,820,38,North Dakota
2020-03-20,NE,32,240,272,31,Nebraska
2020-03-20,NH,44,745,789,33,New Hampshire
2020-03-20,NJ,890,264,1154,34,New Jersey
2020-03-20,NM,43,3771,3814,35,New Mexico
2020-03-20,NV,109,1992,2101,32,Nevada
2020-03-20,NY,7102,25325,32427,36,New York
2020-03-20,OH,169,140,309,39,Ohio
2020-03-20,OK,49,538,587,40,Oklahoma
2020-03-20,OR,114,2003,2117,41,Oregon
2020-03-20,PA,268,2574,2842,42,Pennsylvania
2020-03-20,PR,14,114,128,72,Puerto Rico
2020-03-20,RI,54,800,854,44,Rhode Island
2020-03-20,SC,81,833,914,45,South Carolina
2020-03-20,SD,14,663,677,46,South Dakota
2020-03-20,TN,228,563,791,47,Tennessee
2020-03-20,TX,194,5083,5277,48,Texas
2020-03-20,UT,112,2035,2147,49,Utah
2020-03-20,VA,114,2211,2325,51,Virginia
2020-03-20,VI,3,NA,3,78,U.S. Virgin Islands
2020-03-20,VT,44,957,1001,50,Vermont
2020-03-20,WA,4270,38251,42521,53,Washington
2020-03-20,WI,206,3455,3661,55,Wisconsin
2020-03-20,WV,7,219,226,54,West Virginia
2020-03-20,WY,19,331,350,56,Wyoming
2020-03-19,AK,6,432,438,02,Alaska
2020-03-19,AL,68,28,96,01,Alabama
2020-03-19,AR,46,310,356,05,Arkansas
2020-03-19,AS,NA,NA,0,60,American Samoa
2020-03-19,AZ,44,175,219,04,Arizona
2020-03-19,CA,924,8787,9711,06,California
2020-03-19,CO,216,2112,2328,08,Colorado
2020-03-19,CT,96,604,700,09,Connecticut
2020-03-19,DC,39,153,192,11,District of Columbia
2020-03-19,DE,30,36,66,10,Delaware
2020-03-19,FL,390,1533,1923,12,Florida
2020-03-19,GA,287,1544,1831,13,Georgia
2020-03-19,GU,12,69,81,66,Guam
2020-03-19,HI,16,93,109,15,Hawaii
2020-03-19,IA,38,83,121,19,Iowa
2020-03-19,ID,11,459,470,16,Idaho
2020-03-19,IL,422,2725,3147,17,Illinois
2020-03-19,IN,56,324,380,18,Indiana
2020-03-19,KS,34,417,451,20,Kansas
2020-03-19,KY,35,454,489,21,Kentucky
2020-03-19,LA,347,458,805,22,Louisiana
2020-03-19,MA,229,2918,3147,25,Massachusetts
2020-03-19,MD,107,94,201,24,Maryland
2020-03-19,ME,53,2004,2057,23,Maine
2020-03-19,MI,5276,2051,7327,26,Michigan
2020-03-19,MN,287,2949,3236,27,Minnesota
2020-03-19,MO,24,308,332,29,Missouri
2020-03-19,MP,0,NA,0,69,Northern Mariana Islands
2020-03-19,MS,50,552,602,28,Mississippi
2020-03-19,MT,12,761,773,30,Montana
2020-03-19,NC,97,2408,2505,37,North Carolina
2020-03-19,ND,15,493,508,38,North Dakota
2020-03-19,NE,27,240,267,31,Nebraska
2020-03-19,NH,39,621,660,33,New Hampshire
2020-03-19,NJ,742,210,952,34,New Jersey
2020-03-19,NM,35,2762,2797,35,New Mexico
2020-03-19,NV,95,1626,1721,32,Nevada
2020-03-19,NY,4152,18132,22284,36,New York
2020-03-19,OH,119,140,259,39,Ohio
2020-03-19,OK,44,466,510,40,Oklahoma
2020-03-19,OR,88,1329,1417,41,Oregon
2020-03-19,PA,185,1608,1793,42,Pennsylvania
2020-03-19,PR,5,56,61,72,Puerto Rico
2020-03-19,RI,44,654,698,44,Rhode Island
2020-03-19,SC,60,583,643,45,South Carolina
2020-03-19,SD,11,551,562,46,South Dakota
2020-03-19,TN,154,349,503,47,Tennessee
2020-03-19,TX,143,2212,2355,48,Texas
2020-03-19,UT,78,1448,1526,49,Utah
2020-03-19,VA,94,1829,1923,51,Virginia
2020-03-19,VI,3,NA,3,78,U.S. Virgin Islands
2020-03-19,VT,28,764,792,50,Vermont
2020-03-19,WA,3867,34588,38455,53,Washington
2020-03-19,WI,155,2192,2347,55,Wisconsin
2020-03-19,WV,2,143,145,54,West Virginia
2020-03-19,WY,18,271,289,56,Wyoming
2020-03-18,AK,6,406,412,02,Alaska
2020-03-18,AL,46,28,74,01,Alabama
2020-03-18,AR,33,236,269,05,Arkansas
2020-03-18,AS,NA,NA,0,60,American Samoa
2020-03-18,AZ,28,148,176,04,Arizona
2020-03-18,CA,611,7981,8592,06,California
2020-03-18,CO,183,1617,1800,08,Colorado
2020-03-18,CT,68,125,193,09,Connecticut
2020-03-18,DC,31,138,169,11,District of Columbia
2020-03-18,DE,25,36,61,10,Delaware
2020-03-18,FL,314,1225,1539,12,Florida
2020-03-18,GA,197,1311,1508,13,Georgia
2020-03-18,GU,8,57,65,66,Guam
2020-03-18,HI,14,93,107,15,Hawaii
2020-03-18,IA,29,83,112,19,Iowa
2020-03-18,ID,9,459,468,16,Idaho
2020-03-18,IL,288,1763,2051,17,Illinois
2020-03-18,IN,39,154,193,18,Indiana
2020-03-18,KS,16,417,433,20,Kansas
2020-03-18,KY,26,354,380,21,Kentucky
2020-03-18,LA,240,335,575,22,Louisiana
2020-03-18,MA,156,2115,2271,25,Massachusetts
2020-03-18,MD,85,94,179,24,Maryland
2020-03-18,ME,43,1670,1713,23,Maine
2020-03-18,MI,4531,1478,6009,26,Michigan
2020-03-18,MN,269,2685,2954,27,Minnesota
2020-03-18,MO,13,253,266,29,Missouri
2020-03-18,MP,0,NA,0,69,Northern Mariana Islands
2020-03-18,MS,34,479,513,28,Mississippi
2020-03-18,MT,10,499,509,30,Montana
2020-03-18,NC,63,1787,1850,37,North Carolina
2020-03-18,ND,6,268,274,38,North Dakota
2020-03-18,NE,24,206,230,31,Nebraska
2020-03-18,NH,26,513,539,33,New Hampshire
2020-03-18,NJ,427,190,617,34,New Jersey
2020-03-18,NM,28,2326,2354,35,New Mexico
2020-03-18,NV,55,168,223,32,Nevada
2020-03-18,NY,2382,12215,14597,36,New York
2020-03-18,OH,88,140,228,39,Ohio
2020-03-18,OK,29,378,407,40,Oklahoma
2020-03-18,OR,75,1118,1193,41,Oregon
2020-03-18,PA,133,1187,1320,42,Pennsylvania
2020-03-18,PR,5,31,36,72,Puerto Rico
2020-03-18,RI,33,540,573,44,Rhode Island
2020-03-18,SC,60,583,643,45,South Carolina
2020-03-18,SD,11,551,562,46,South Dakota
2020-03-18,TN,98,349,447,47,Tennessee
2020-03-18,TX,83,1824,1907,48,Texas
2020-03-18,UT,63,131,194,49,Utah
2020-03-18,VA,77,1201,1278,51,Virginia
2020-03-18,VI,2,NA,2,78,U.S. Virgin Islands
2020-03-18,VT,21,637,658,50,Vermont
2020-03-18,WA,3532,30372,33904,53,Washington
2020-03-18,WI,106,1577,1683,55,Wisconsin
2020-03-18,WV,1,122,123,54,West Virginia
2020-03-18,WY,15,178,193,56,Wyoming
2020-03-17,AK,3,334,337,02,Alaska
2020-03-17,AL,36,28,64,01,Alabama
2020-03-17,AR,22,197,219,05,Arkansas
2020-03-17,AS,NA,NA,0,60,American Samoa
2020-03-17,AZ,20,142,162,04,Arizona
2020-03-17,CA,483,7981,8464,06,California
2020-03-17,CO,160,1056,1216,08,Colorado
2020-03-17,CT,41,125,166,09,Connecticut
2020-03-17,DC,22,104,126,11,District of Columbia
2020-03-17,DE,16,36,52,10,Delaware
2020-03-17,FL,186,940,1126,12,Florida
2020-03-17,GA,146,NA,146,13,Georgia
2020-03-17,GU,5,41,46,66,Guam
2020-03-17,HI,10,NA,10,15,Hawaii
2020-03-17,IA,23,83,106,19,Iowa
2020-03-17,ID,7,346,353,16,Idaho
2020-03-17,IL,159,1340,1499,17,Illinois
2020-03-17,IN,30,129,159,18,Indiana
2020-03-17,KS,15,382,397,20,Kansas
2020-03-17,KY,22,295,317,21,Kentucky
2020-03-17,LA,137,286,423,22,Louisiana
2020-03-17,MA,118,1633,1751,25,Massachusetts
2020-03-17,MD,57,94,151,24,Maryland
2020-03-17,ME,32,1303,1335,23,Maine
2020-03-17,MI,3659,879,4538,26,Michigan
2020-03-17,MN,246,2276,2522,27,Minnesota
2020-03-17,MO,8,207,215,29,Missouri
2020-03-17,MP,0,NA,0,69,Northern Mariana Islands
2020-03-17,MS,21,368,389,28,Mississippi
2020-03-17,MT,8,303,311,30,Montana
2020-03-17,NC,40,474,514,37,North Carolina
2020-03-17,ND,3,220,223,38,North Dakota
2020-03-17,NE,21,206,227,31,Nebraska
2020-03-17,NH,17,355,372,33,New Hampshire
2020-03-17,NJ,267,163,430,34,New Jersey
2020-03-17,NM,23,1249,1272,35,New Mexico
2020-03-17,NV,55,168,223,32,Nevada
2020-03-17,NY,1700,5506,7206,36,New York
2020-03-17,OH,67,140,207,39,Ohio
2020-03-17,OK,17,247,264,40,Oklahoma
2020-03-17,OR,47,689,736,41,Oregon
2020-03-17,PA,96,879,975,42,Pennsylvania
2020-03-17,PR,5,13,18,72,Puerto Rico
2020-03-17,RI,23,403,426,44,Rhode Island
2020-03-17,SC,33,311,344,45,South Carolina
2020-03-17,SD,11,551,562,46,South Dakota
2020-03-17,TN,73,330,403,47,Tennessee
2020-03-17,TX,64,1204,1268,48,Texas
2020-03-17,UT,51,131,182,49,Utah
2020-03-17,VA,67,961,1028,51,Virginia
2020-03-17,VI,2,NA,2,78,U.S. Virgin Islands
2020-03-17,VT,19,581,600,50,Vermont
2020-03-17,WA,3154,26008,29162,53,Washington
2020-03-17,WI,72,1038,1110,55,Wisconsin
2020-03-17,WV,0,80,80,54,West Virginia
2020-03-17,WY,10,95,105,56,Wyoming
2020-03-16,AK,1,143,144,02,Alaska
2020-03-16,AL,28,28,56,01,Alabama
2020-03-16,AR,22,132,154,05,Arkansas
2020-03-16,AS,NA,NA,0,60,American Samoa
2020-03-16,AZ,18,125,143,04,Arizona
2020-03-16,CA,335,7981,8316,06,California
2020-03-16,CO,131,627,758,08,Colorado
2020-03-16,CT,26,125,151,09,Connecticut
2020-03-16,DC,17,96,113,11,District of Columbia
2020-03-16,DE,8,36,44,10,Delaware
2020-03-16,FL,141,684,825,12,Florida
2020-03-16,GA,121,NA,121,13,Georgia
2020-03-16,GU,3,23,26,66,Guam
2020-03-16,HI,7,NA,7,15,Hawaii
2020-03-16,IA,22,83,105,19,Iowa
2020-03-16,ID,5,265,270,16,Idaho
2020-03-16,IL,93,932,1025,17,Illinois
2020-03-16,IN,24,115,139,18,Indiana
2020-03-16,KS,11,166,177,20,Kansas
2020-03-16,KY,21,234,255,21,Kentucky
2020-03-16,LA,115,188,303,22,Louisiana
2020-03-16,MA,97,1199,1296,25,Massachusetts
2020-03-16,MD,2895,193,3088,24,Maryland
2020-03-16,ME,17,764,781,23,Maine
2020-03-16,MI,1933,272,2205,26,Michigan
2020-03-16,MN,179,1839,2018,27,Minnesota
2020-03-16,MO,6,164,170,29,Missouri
2020-03-16,MP,0,NA,0,69,Northern Mariana Islands
2020-03-16,MS,12,277,289,28,Mississippi
2020-03-16,MT,7,198,205,30,Montana
2020-03-16,NC,33,296,329,37,North Carolina
2020-03-16,ND,1,123,124,38,North Dakota
2020-03-16,NE,18,170,188,31,Nebraska
2020-03-16,NH,13,271,284,33,New Hampshire
2020-03-16,NJ,178,120,298,34,New Jersey
2020-03-16,NM,17,566,583,35,New Mexico
2020-03-16,NV,45,168,213,32,Nevada
2020-03-16,NY,950,4543,5493,36,New York
2020-03-16,OH,50,140,190,39,Ohio
2020-03-16,OK,10,174,184,40,Oklahoma
2020-03-16,OR,39,579,618,41,Oregon
2020-03-16,PA,76,670,746,42,Pennsylvania
2020-03-16,PR,5,9,14,72,Puerto Rico
2020-03-16,RI,21,308,329,44,Rhode Island
2020-03-16,SC,28,235,263,45,South Carolina
2020-03-16,SD,10,494,504,46,South Dakota
2020-03-16,TN,52,270,322,47,Tennessee
2020-03-16,TX,57,NA,57,48,Texas
2020-03-16,UT,39,131,170,49,Utah
2020-03-16,VA,51,438,489,51,Virginia
2020-03-16,VI,1,NA,1,78,U.S. Virgin Islands
2020-03-16,VT,17,487,504,50,Vermont
2020-03-16,WA,2830,21691,24521,53,Washington
2020-03-16,WI,47,504,551,55,Wisconsin
2020-03-16,WV,0,80,80,54,West Virginia
2020-03-16,WY,3,NA,3,56,Wyoming
2020-03-15,AK,1,143,144,02,Alaska
2020-03-15,AL,12,28,40,01,Alabama
2020-03-15,AR,16,103,119,05,Arkansas
2020-03-15,AZ,12,121,133,04,Arizona
2020-03-15,CA,293,916,1209,06,California
2020-03-15,CO,131,627,758,08,Colorado
2020-03-15,CT,20,125,145,09,Connecticut
2020-03-15,DC,16,79,95,11,District of Columbia
2020-03-15,DE,6,36,42,10,Delaware
2020-03-15,FL,116,678,794,12,Florida
2020-03-15,GA,99,NA,99,13,Georgia
2020-03-15,HI,2,NA,2,15,Hawaii
2020-03-15,IA,18,83,101,19,Iowa
2020-03-15,ID,5,174,179,16,Idaho
2020-03-15,IL,64,449,513,17,Illinois
2020-03-15,IN,19,102,121,18,Indiana
2020-03-15,KS,8,135,143,20,Kansas
2020-03-15,KY,2188,53,2241,21,Kentucky
2020-03-15,LA,90,156,246,22,Louisiana
2020-03-15,MA,64,584,648,25,Massachusetts
2020-03-15,MD,31,94,125,24,Maryland
2020-03-15,ME,3,91,94,23,Maine
2020-03-15,MI,1480,205,1685,26,Michigan
2020-03-15,MN,128,1387,1515,27,Minnesota
2020-03-15,MO,5,122,127,29,Missouri
2020-03-15,MS,10,84,94,28,Mississippi
2020-03-15,MT,7,103,110,30,Montana
2020-03-15,NC,32,227,259,37,North Carolina
2020-03-15,ND,1,95,96,38,North Dakota
2020-03-15,NE,17,80,97,31,Nebraska
2020-03-15,NH,13,271,284,33,New Hampshire
2020-03-15,NJ,98,120,218,34,New Jersey
2020-03-15,NM,13,482,495,35,New Mexico
2020-03-15,NV,21,168,189,32,Nevada
2020-03-15,NY,729,4543,5272,36,New York
2020-03-15,OH,36,139,175,39,Ohio
2020-03-15,OK,9,118,127,40,Oklahoma
2020-03-15,OR,36,420,456,41,Oregon
2020-03-15,PA,63,205,268,42,Pennsylvania
2020-03-15,RI,20,271,291,44,Rhode Island
2020-03-15,SC,19,154,173,45,South Carolina
2020-03-15,SD,9,327,336,46,South Dakota
2020-03-15,TN,39,157,196,47,Tennessee
2020-03-15,TX,56,NA,56,48,Texas
2020-03-15,UT,28,131,159,49,Utah
2020-03-15,VA,45,363,408,51,Virginia
2020-03-15,VT,12,405,417,50,Vermont
2020-03-15,WA,2462,17160,19622,53,Washington
2020-03-15,WI,33,313,346,55,Wisconsin
2020-03-15,WV,0,38,38,54,West Virginia
2020-03-15,WY,3,NA,3,56,Wyoming
2020-03-14,AK,1,143,144,02,Alaska
2020-03-14,AL,6,22,28,01,Alabama
2020-03-14,AR,12,65,77,05,Arkansas
2020-03-14,AZ,12,121,133,04,Arizona
2020-03-14,CA,252,916,1168,06,California
2020-03-14,CO,101,610,711,08,Colorado
2020-03-14,CT,11,125,136,09,Connecticut
2020-03-14,DC,10,49,59,11,District of Columbia
2020-03-14,DE,6,36,42,10,Delaware
2020-03-14,FL,77,478,555,12,Florida
2020-03-14,GA,66,NA,66,13,Georgia
2020-03-14,HI,2,NA,2,15,Hawaii
2020-03-14,IA,17,83,100,19,Iowa
2020-03-14,ID,2,174,176,16,Idaho
2020-03-14,IL,46,316,362,17,Illinois
2020-03-14,IN,15,74,89,18,Indiana
2020-03-14,KS,6,93,99,20,Kansas
2020-03-14,KY,1728,41,1769,21,Kentucky
2020-03-14,LA,51,109,160,22,Louisiana
2020-03-14,MA,38,NA,38,25,Massachusetts
2020-03-14,MD,26,94,120,24,Maryland
2020-03-14,ME,3,91,94,23,Maine
2020-03-14,MI,1196,205,1401,26,Michigan
2020-03-14,MN,90,847,937,27,Minnesota
2020-03-14,MO,4,90,94,29,Missouri
2020-03-14,MS,6,84,90,28,Mississippi
2020-03-14,MT,5,103,108,30,Montana
2020-03-14,NC,23,137,160,37,North Carolina
2020-03-14,ND,1,54,55,38,North Dakota
2020-03-14,NE,14,80,94,31,Nebraska
2020-03-14,NH,7,212,219,33,New Hampshire
2020-03-14,NJ,50,97,147,34,New Jersey
2020-03-14,NM,10,237,247,35,New Mexico
2020-03-14,NV,20,168,188,32,Nevada
2020-03-14,NY,524,2779,3303,36,New York
2020-03-14,OH,13,50,63,39,Ohio
2020-03-14,OK,4,36,40,40,Oklahoma
2020-03-14,OR,30,337,367,41,Oregon
2020-03-14,PA,47,205,252,42,Pennsylvania
2020-03-14,RI,20,198,218,44,Rhode Island
2020-03-14,SC,13,110,123,45,South Carolina
2020-03-14,SD,9,182,191,46,South Dakota
2020-03-14,TN,32,130,162,47,Tennessee
2020-03-14,TX,51,NA,51,48,Texas
2020-03-14,UT,6,131,137,49,Utah
2020-03-14,VA,30,117,147,51,Virginia
2020-03-14,VT,8,332,340,50,Vermont
2020-03-14,WA,2208,15724,17932,53,Washington
2020-03-14,WI,19,169,188,55,Wisconsin
2020-03-14,WV,0,26,26,54,West Virginia
2020-03-14,WY,2,NA,2,56,Wyoming
2020-03-13,AK,1,59,60,02,Alaska
2020-03-13,AL,1,11,12,01,Alabama
2020-03-13,AR,9,30,39,05,Arkansas
2020-03-13,AZ,9,94,103,04,Arizona
2020-03-13,CA,202,916,1118,06,California
2020-03-13,CO,72,524,596,08,Colorado
2020-03-13,CT,6,99,105,09,Connecticut
2020-03-13,DC,10,20,30,11,District of Columbia
2020-03-13,DE,4,30,34,10,Delaware
2020-03-13,FL,50,478,528,12,Florida
2020-03-13,GA,42,NA,42,13,Georgia
2020-03-13,HI,2,NA,2,15,Hawaii
2020-03-13,IA,16,83,99,19,Iowa
2020-03-13,ID,0,131,131,16,Idaho
2020-03-13,IL,32,294,326,17,Illinois
2020-03-13,IN,12,61,73,18,Indiana
2020-03-13,KS,6,93,99,20,Kansas
2020-03-13,KY,1361,23,1384,21,Kentucky
2020-03-13,LA,36,37,73,22,Louisiana
2020-03-13,MA,23,NA,23,25,Massachusetts
2020-03-13,MD,17,94,111,24,Maryland
2020-03-13,ME,3,91,94,23,Maine
2020-03-13,MI,945,133,1078,26,Michigan
2020-03-13,MN,62,541,603,27,Minnesota
2020-03-13,MO,2,71,73,29,Missouri
2020-03-13,MS,4,41,45,28,Mississippi
2020-03-13,MT,1,55,56,30,Montana
2020-03-13,NC,15,86,101,37,North Carolina
2020-03-13,ND,1,39,40,38,North Dakota
2020-03-13,NE,13,80,93,31,Nebraska
2020-03-13,NH,6,94,100,33,New Hampshire
2020-03-13,NJ,50,97,147,34,New Jersey
2020-03-13,NM,10,190,200,35,New Mexico
2020-03-13,NV,11,168,179,32,Nevada
2020-03-13,NY,421,2779,3200,36,New York
2020-03-13,OH,13,50,63,39,Ohio
2020-03-13,OK,3,36,39,40,Oklahoma
2020-03-13,OR,30,337,367,41,Oregon
2020-03-13,PA,41,140,181,42,Pennsylvania
2020-03-13,RI,14,142,156,44,Rhode Island
2020-03-13,SC,12,75,87,45,South Carolina
2020-03-13,SD,9,73,82,46,South Dakota
2020-03-13,TN,26,116,142,47,Tennessee
2020-03-13,TX,39,NA,39,48,Texas
2020-03-13,UT,6,131,137,49,Utah
2020-03-13,VA,30,117,147,51,Virginia
2020-03-13,VT,5,223,228,50,Vermont
2020-03-13,WA,1943,13655,15598,53,Washington
2020-03-13,WI,19,169,188,55,Wisconsin
2020-03-13,WV,0,17,17,54,West Virginia
2020-03-13,WY,1,NA,1,56,Wyoming
2020-03-12,AK,0,46,46,02,Alaska
2020-03-12,AL,0,10,10,01,Alabama
2020-03-12,AR,6,24,30,05,Arkansas
2020-03-12,AZ,9,82,91,04,Arizona
2020-03-12,CA,202,916,1118,06,California
2020-03-12,CO,45,298,343,08,Colorado
2020-03-12,CT,6,89,95,09,Connecticut
2020-03-12,DC,10,20,30,11,District of Columbia
2020-03-12,DE,4,23,27,10,Delaware
2020-03-12,FL,32,301,333,12,Florida
2020-03-12,GA,31,NA,31,13,Georgia
2020-03-12,HI,2,NA,2,15,Hawaii
2020-03-12,IA,14,67,81,19,Iowa
2020-03-12,ID,0,93,93,16,Idaho
2020-03-12,IL,25,266,291,17,Illinois
2020-03-12,IN,12,52,64,18,Indiana
2020-03-12,KS,997,15,1012,20,Kansas
2020-03-12,KY,8,56,64,21,Kentucky
2020-03-12,LA,14,37,51,22,Louisiana
2020-03-12,MA,8,NA,8,25,Massachusetts
2020-03-12,MD,12,94,106,24,Maryland
2020-03-12,ME,1,65,66,23,Maine
2020-03-12,MI,702,91,793,26,Michigan
2020-03-12,MN,43,307,350,27,Minnesota
2020-03-12,MO,1,64,65,29,Missouri
2020-03-12,MS,1,41,42,28,Mississippi
2020-03-12,MT,1,34,35,30,Montana
2020-03-12,NC,12,60,72,37,North Carolina
2020-03-12,ND,1,12,13,38,North Dakota
2020-03-12,NE,10,80,90,31,Nebraska
2020-03-12,NH,6,94,100,33,New Hampshire
2020-03-12,NJ,30,74,104,34,New Jersey
2020-03-12,NM,5,155,160,35,New Mexico
2020-03-12,NV,7,168,175,32,Nevada
2020-03-12,NY,216,92,308,36,New York
2020-03-12,OH,5,30,35,39,Ohio
2020-03-12,OK,3,36,39,40,Oklahoma
2020-03-12,OR,19,286,305,41,Oregon
2020-03-12,PA,22,116,138,42,Pennsylvania
2020-03-12,RI,5,94,99,44,Rhode Island
2020-03-12,SC,10,48,58,45,South Carolina
2020-03-12,SD,8,27,35,46,South Dakota
2020-03-12,TN,18,79,97,47,Tennessee
2020-03-12,TX,23,NA,23,48,Texas
2020-03-12,UT,4,131,135,49,Utah
2020-03-12,VA,17,117,134,51,Virginia
2020-03-12,VT,2,136,138,50,Vermont
2020-03-12,WA,1646,9718,11364,53,Washington
2020-03-12,WI,8,84,92,55,Wisconsin
2020-03-12,WV,0,7,7,54,West Virginia
2020-03-12,WY,1,NA,1,56,Wyoming
2020-03-11,AK,0,46,46,02,Alaska
2020-03-11,AL,0,10,10,01,Alabama
2020-03-11,AR,0,12,12,05,Arkansas
2020-03-11,AZ,9,59,68,04,Arizona
2020-03-11,CA,157,916,1073,06,California
2020-03-11,CO,28,251,279,08,Colorado
2020-03-11,CT,3,71,74,09,Connecticut
2020-03-11,DC,5,20,25,11,District of Columbia
2020-03-11,DE,1,17,18,10,Delaware
2020-03-11,FL,28,301,329,12,Florida
2020-03-11,GA,22,NA,22,13,Georgia
2020-03-11,HI,2,NA,2,15,Hawaii
2020-03-11,IA,13,46,59,19,Iowa
2020-03-11,ID,0,67,67,16,Idaho
2020-03-11,IL,19,244,263,17,Illinois
2020-03-11,IN,727,2,729,18,Indiana
2020-03-11,KS,1,41,42,20,Kansas
2020-03-11,KY,8,46,54,21,Kentucky
2020-03-11,LA,6,37,43,22,Louisiana
2020-03-11,MD,9,94,103,24,Maryland
2020-03-11,ME,0,42,42,23,Maine
2020-03-11,MI,497,57,554,26,Michigan
2020-03-11,MN,21,217,238,27,Minnesota
2020-03-11,MO,1,NA,1,29,Missouri
2020-03-11,MS,0,20,20,28,Mississippi
2020-03-11,MT,0,21,21,30,Montana
2020-03-11,NC,7,NA,7,37,North Carolina
2020-03-11,ND,0,7,7,38,North Dakota
2020-03-11,NE,5,47,52,31,Nebraska
2020-03-11,NH,4,38,42,33,New Hampshire
2020-03-11,NJ,24,57,81,34,New Jersey
2020-03-11,NM,3,87,90,35,New Mexico
2020-03-11,NV,5,168,173,32,Nevada
2020-03-11,NY,216,92,308,36,New York
2020-03-11,OH,4,21,25,39,Ohio
2020-03-11,OK,2,15,17,40,Oklahoma
2020-03-11,OR,19,286,305,41,Oregon
2020-03-11,PA,16,88,104,42,Pennsylvania
2020-03-11,RI,5,94,99,44,Rhode Island
2020-03-11,SC,9,32,41,45,South Carolina
2020-03-11,SD,5,13,18,46,South Dakota
2020-03-11,TN,7,50,57,47,Tennessee
2020-03-11,TX,21,NA,21,48,Texas
2020-03-11,UT,2,NA,2,49,Utah
2020-03-11,VA,9,60,69,51,Virginia
2020-03-11,VT,2,91,93,50,Vermont
2020-03-11,WA,1390,6210,7600,53,Washington
2020-03-11,WI,3,43,46,55,Wisconsin
2020-03-11,WV,0,3,3,54,West Virginia
2020-03-11,WY,0,NA,0,56,Wyoming
2020-03-10,AK,0,23,23,02,Alaska
2020-03-10,AL,0,0,0,01,Alabama
2020-03-10,AR,0,12,12,05,Arkansas
2020-03-10,AZ,6,51,57,04,Arizona
2020-03-10,CA,133,690,823,06,California
2020-03-10,CO,12,142,154,08,Colorado
2020-03-10,CT,2,54,56,09,Connecticut
2020-03-10,DC,5,17,22,11,District of Columbia
2020-03-10,DE,0,17,17,10,Delaware
2020-03-10,FL,19,222,241,12,Florida
2020-03-10,GA,17,NA,17,13,Georgia
2020-03-10,HI,2,NA,2,15,Hawaii
2020-03-10,IA,8,32,40,19,Iowa
2020-03-10,ID,0,41,41,16,Idaho
2020-03-10,IL,19,244,263,17,Illinois
2020-03-10,IN,528,1,529,18,Indiana
2020-03-10,KS,1,17,18,20,Kansas
2020-03-10,KY,6,28,34,21,Kentucky
2020-03-10,LA,1,11,12,22,Louisiana
2020-03-10,MD,6,89,95,24,Maryland
2020-03-10,ME,0,20,20,23,Maine
2020-03-10,MI,358,39,397,26,Michigan
2020-03-10,MN,11,132,143,27,Minnesota
2020-03-10,MO,1,NA,1,29,Missouri
2020-03-10,MS,0,NA,0,28,Mississippi
2020-03-10,MT,0,15,15,30,Montana
2020-03-10,NC,7,NA,7,37,North Carolina
2020-03-10,ND,0,6,6,38,North Dakota
2020-03-10,NE,3,47,50,31,Nebraska
2020-03-10,NH,4,38,42,33,New Hampshire
2020-03-10,NJ,15,44,59,34,New Jersey
2020-03-10,NM,0,69,69,35,New Mexico
2020-03-10,NV,1,14,15,32,Nevada
2020-03-10,NY,173,92,265,36,New York
2020-03-10,OH,3,14,17,39,Ohio
2020-03-10,OK,2,15,17,40,Oklahoma
2020-03-10,OR,15,213,228,41,Oregon
2020-03-10,PA,12,NA,12,42,Pennsylvania
2020-03-10,RI,3,58,61,44,Rhode Island
2020-03-10,SC,7,24,31,45,South Carolina
2020-03-10,SD,0,11,11,46,South Dakota
2020-03-10,TN,7,NA,7,47,Tennessee
2020-03-10,TX,13,NA,13,48,Texas
2020-03-10,UT,2,NA,2,49,Utah
2020-03-10,VA,8,53,61,51,Virginia
2020-03-10,VT,1,60,61,50,Vermont
2020-03-10,WA,1178,4156,5334,53,Washington
2020-03-10,WI,2,36,38,55,Wisconsin
2020-03-10,WV,0,2,2,54,West Virginia
2020-03-10,WY,0,0,0,56,Wyoming
2020-03-09,AK,0,23,23,02,Alaska
2020-03-09,AL,0,NA,0,01,Alabama
2020-03-09,AR,0,12,12,05,Arkansas
2020-03-09,AZ,5,44,49,04,Arizona
2020-03-09,CA,114,690,804,06,California
2020-03-09,CO,9,133,142,08,Colorado
2020-03-09,CT,1,46,47,09,Connecticut
2020-03-09,DC,1,14,15,11,District of Columbia
2020-03-09,DE,0,15,15,10,Delaware
2020-03-09,FL,18,140,158,12,Florida
2020-03-09,GA,12,NA,12,13,Georgia
2020-03-09,HI,2,NA,2,15,Hawaii
2020-03-09,IA,3,26,29,19,Iowa
2020-03-09,ID,0,41,41,16,Idaho
2020-03-09,IL,7,191,198,17,Illinois
2020-03-09,IN,372,36,408,18,Indiana
2020-03-09,KS,1,11,12,20,Kansas
2020-03-09,KY,4,17,21,21,Kentucky
2020-03-09,LA,1,5,6,22,Louisiana
2020-03-09,MD,5,73,78,24,Maryland
2020-03-09,ME,0,1,1,23,Maine
2020-03-09,MI,254,36,290,26,Michigan
2020-03-09,MN,5,80,85,27,Minnesota
2020-03-09,MO,1,NA,1,29,Missouri
2020-03-09,MS,0,NA,0,28,Mississippi
2020-03-09,MT,0,11,11,30,Montana
2020-03-09,NC,2,NA,2,37,North Carolina
2020-03-09,ND,0,0,0,38,North Dakota
2020-03-09,NE,3,36,39,31,Nebraska
2020-03-09,NH,4,38,42,33,New Hampshire
2020-03-09,NJ,11,35,46,34,New Jersey
2020-03-09,NM,0,57,57,35,New Mexico
2020-03-09,NV,1,14,15,32,Nevada
2020-03-09,NY,142,92,234,36,New York
2020-03-09,OH,3,11,14,39,Ohio
2020-03-09,OK,1,8,9,40,Oklahoma
2020-03-09,OR,14,165,179,41,Oregon
2020-03-09,PA,10,NA,10,42,Pennsylvania
2020-03-09,RI,3,30,33,44,Rhode Island
2020-03-09,SC,7,24,31,45,South Carolina
2020-03-09,SD,0,5,5,46,South Dakota
2020-03-09,TN,3,NA,3,47,Tennessee
2020-03-09,TX,12,NA,12,48,Texas
2020-03-09,UT,1,NA,1,49,Utah
2020-03-09,VA,3,38,41,51,Virginia
2020-03-09,VT,1,36,37,50,Vermont
2020-03-09,WA,962,2589,3551,53,Washington
2020-03-09,WI,1,36,37,55,Wisconsin
2020-03-09,WV,0,2,2,54,West Virginia
2020-03-09,WY,0,NA,0,56,Wyoming
2020-03-08,AK,0,14,14,02,Alaska
2020-03-08,AL,0,NA,0,01,Alabama
2020-03-08,AR,0,6,6,05,Arkansas
2020-03-08,AZ,5,44,49,04,Arizona
2020-03-08,CA,88,462,550,06,California
2020-03-08,CO,8,104,112,08,Colorado
2020-03-08,CT,1,29,30,09,Connecticut
2020-03-08,DC,1,10,11,11,District of Columbia
2020-03-08,DE,0,10,10,10,Delaware
2020-03-08,FL,17,118,135,12,Florida
2020-03-08,GA,7,NA,7,13,Georgia
2020-03-08,HI,1,NA,1,15,Hawaii
2020-03-08,IA,0,15,15,19,Iowa
2020-03-08,ID,0,27,27,16,Idaho
2020-03-08,IL,6,191,197,17,Illinois
2020-03-08,IN,251,26,277,18,Indiana
2020-03-08,KS,1,11,12,20,Kansas
2020-03-08,KY,1,13,14,21,Kentucky
2020-03-08,LA,0,5,5,22,Louisiana
2020-03-08,MD,3,52,55,24,Maryland
2020-03-08,ME,0,1,1,23,Maine
2020-03-08,MI,168,26,194,26,Michigan
2020-03-08,MN,2,48,50,27,Minnesota
2020-03-08,MO,1,NA,1,29,Missouri
2020-03-08,MS,0,NA,0,28,Mississippi
2020-03-08,MT,0,11,11,30,Montana
2020-03-08,NC,2,NA,2,37,North Carolina
2020-03-08,ND,0,0,0,38,North Dakota
2020-03-08,NE,1,17,18,31,Nebraska
2020-03-08,NH,4,38,42,33,New Hampshire
2020-03-08,NJ,6,31,37,34,New Jersey
2020-03-08,NM,0,48,48,35,New Mexico
2020-03-08,NV,1,14,15,32,Nevada
2020-03-08,NY,105,92,197,36,New York
2020-03-08,OH,0,10,10,39,Ohio
2020-03-08,OK,1,8,9,40,Oklahoma
2020-03-08,OR,14,100,114,41,Oregon
2020-03-08,PA,6,NA,6,42,Pennsylvania
2020-03-08,RI,3,30,33,44,Rhode Island
2020-03-08,SC,2,8,10,45,South Carolina
2020-03-08,SD,0,5,5,46,South Dakota
2020-03-08,TN,3,NA,3,47,Tennessee
2020-03-08,TX,8,NA,8,48,Texas
2020-03-08,UT,1,NA,1,49,Utah
2020-03-08,VA,2,36,38,51,Virginia
2020-03-08,VT,1,30,31,50,Vermont
2020-03-08,WA,789,1738,2527,53,Washington
2020-03-08,WI,1,31,32,55,Wisconsin
2020-03-08,WV,0,2,2,54,West Virginia
2020-03-08,WY,0,NA,0,56,Wyoming
2020-03-07,AK,0,12,12,02,Alaska
2020-03-07,AL,0,NA,0,01,Alabama
2020-03-07,AR,0,6,6,05,Arkansas
2020-03-07,AZ,5,44,49,04,Arizona
2020-03-07,CA,69,462,531,06,California
2020-03-07,CO,8,55,63,08,Colorado
2020-03-07,CT,0,NA,0,09,Connecticut
2020-03-07,DC,0,8,8,11,District of Columbia
2020-03-07,DE,0,10,10,10,Delaware
2020-03-07,FL,188,18,206,12,Florida
2020-03-07,GA,6,NA,6,13,Georgia
2020-03-07,HI,1,NA,1,15,Hawaii
2020-03-07,IA,0,15,15,19,Iowa
2020-03-07,ID,0,27,27,16,Idaho
2020-03-07,IL,6,191,197,17,Illinois
2020-03-07,IN,1,NA,1,18,Indiana
2020-03-07,KS,0,11,11,20,Kansas
2020-03-07,KY,1,9,10,21,Kentucky
2020-03-07,LA,0,NA,0,22,Louisiana
2020-03-07,MD,3,41,44,24,Maryland
2020-03-07,ME,0,1,1,23,Maine
2020-03-07,MI,128,18,146,26,Michigan
2020-03-07,MN,2,48,50,27,Minnesota
2020-03-07,MO,0,NA,0,29,Missouri
2020-03-07,MS,0,NA,0,28,Mississippi
2020-03-07,MT,0,11,11,30,Montana
2020-03-07,NC,2,NA,2,37,North Carolina
2020-03-07,ND,0,0,0,38,North Dakota
2020-03-07,NE,1,17,18,31,Nebraska
2020-03-07,NH,2,20,22,33,New Hampshire
2020-03-07,NJ,4,NA,4,34,New Jersey
2020-03-07,NM,0,48,48,35,New Mexico
2020-03-07,NV,1,14,15,32,Nevada
2020-03-07,NY,76,92,168,36,New York
2020-03-07,OH,0,9,9,39,Ohio
2020-03-07,OK,1,NA,1,40,Oklahoma
2020-03-07,OR,7,77,84,41,Oregon
2020-03-07,PA,4,NA,4,42,Pennsylvania
2020-03-07,RI,140,8,148,44,Rhode Island
2020-03-07,SC,2,8,10,45,South Carolina
2020-03-07,SD,0,5,5,46,South Dakota
2020-03-07,TN,1,NA,1,47,Tennessee
2020-03-07,TX,8,NA,8,48,Texas
2020-03-07,UT,1,NA,1,49,Utah
2020-03-07,VA,0,31,31,51,Virginia
2020-03-07,VT,1,25,26,50,Vermont
2020-03-07,WA,636,1368,2004,53,Washington
2020-03-07,WI,1,31,32,55,Wisconsin
2020-03-07,WV,0,2,2,54,West Virginia
2020-03-07,WY,0,NA,0,56,Wyoming
2020-03-06,AK,0,8,8,02,Alaska
2020-03-06,AR,0,6,6,05,Arkansas
2020-03-06,AZ,3,33,36,04,Arizona
2020-03-06,CA,60,462,522,06,California
2020-03-06,CO,2,46,48,08,Colorado
2020-03-06,DC,0,8,8,11,District of Columbia
2020-03-06,DE,0,10,10,10,Delaware
2020-03-06,FL,9,55,64,12,Florida
2020-03-06,GA,2,NA,2,13,Georgia
2020-03-06,IA,100,8,108,19,Iowa
2020-03-06,IL,5,180,185,17,Illinois
2020-03-06,IN,1,NA,1,18,Indiana
2020-03-06,KS,0,4,4,20,Kansas
2020-03-06,KY,0,7,7,21,Kentucky
2020-03-06,MD,3,26,29,24,Maryland
2020-03-06,MI,98,8,106,26,Michigan
2020-03-06,MN,1,36,37,27,Minnesota
2020-03-06,NC,2,NA,2,37,North Carolina
2020-03-06,NE,0,17,17,31,Nebraska
2020-03-06,NH,74,NA,74,33,New Hampshire
2020-03-06,NJ,1,NA,1,34,New Jersey
2020-03-06,NM,0,16,16,35,New Mexico
2020-03-06,NV,50,14,64,32,Nevada
2020-03-06,NY,33,92,125,36,New York
2020-03-06,OH,0,8,8,39,Ohio
2020-03-06,OR,27,64,91,41,Oregon
2020-03-06,PA,2,NA,2,42,Pennsylvania
2020-03-06,RI,3,17,20,44,Rhode Island
2020-03-06,SC,0,5,5,45,South Carolina
2020-03-06,TN,1,NA,1,47,Tennessee
2020-03-06,TX,5,NA,5,48,Texas
2020-03-06,VA,0,21,21,51,Virginia
2020-03-06,VT,0,0,0,50,Vermont
2020-03-06,WA,537,1063,1600,53,Washington
2020-03-06,WI,1,31,32,55,Wisconsin
2020-03-06,WV,0,1,1,54,West Virginia
2020-03-05,AZ,2,28,30,04,Arizona
2020-03-05,CA,53,462,515,06,California
2020-03-05,CO,0,19,19,08,Colorado
2020-03-05,DC,0,6,6,11,District of Columbia
2020-03-05,FL,9,31,40,12,Florida
2020-03-05,GA,2,NA,2,13,Georgia
2020-03-05,IL,5,165,170,17,Illinois
2020-03-05,MD,0,17,17,24,Maryland
2020-03-05,MI,72,8,80,26,Michigan
2020-03-05,NC,1,NA,1,37,North Carolina
2020-03-05,NE,0,17,17,31,Nebraska
2020-03-05,NH,2,16,18,33,New Hampshire
2020-03-05,NJ,1,NA,1,34,New Jersey
2020-03-05,NV,1,14,15,32,Nevada
2020-03-05,NY,22,76,98,36,New York
2020-03-05,OH,0,7,7,39,Ohio
2020-03-05,OR,3,45,48,41,Oregon
2020-03-05,RI,2,17,19,44,Rhode Island
2020-03-05,SC,0,5,5,45,South Carolina
2020-03-05,TN,1,NA,1,47,Tennessee
2020-03-05,TX,1,NA,1,48,Texas
2020-03-05,VA,0,18,18,51,Virginia
2020-03-05,WA,456,669,1125,53,Washington
2020-03-05,WI,1,19,20,55,Wisconsin
2020-03-04,AZ,2,27,29,04,Arizona
2020-03-04,CA,53,462,515,06,California
2020-03-04,FL,2,24,26,12,Florida
2020-03-04,GA,2,NA,2,13,Georgia
2020-03-04,IL,4,124,128,17,Illinois
2020-03-04,MI,52,NA,52,26,Michigan
2020-03-04,NC,1,NA,1,37,North Carolina
2020-03-04,NH,14,10,24,33,New Hampshire
2020-03-04,NY,6,48,54,36,New York
2020-03-04,OR,3,29,32,41,Oregon
2020-03-04,RI,2,11,13,44,Rhode Island
2020-03-04,SC,0,5,5,45,South Carolina
2020-03-04,TX,1,NA,1,48,Texas
2020-03-04,WA,351,413,764,53,Washington
2020-03-04,WI,1,19,20,55,Wisconsin
2020-03-03,MI,34,NA,34,26,Michigan
2020-03-03,RI,2,6,8,44,Rhode Island
2020-03-03,WA,258,262,520,53,Washington
2020-03-02,MI,18,NA,18,26,Michigan
2020-03-02,RI,1,NA,1,44,Rhode Island
2020-03-02,WA,174,122,296,53,Washington
2020-03-01,MI,9,NA,9,26,Michigan
2020-03-01,RI,1,NA,1,44,Rhode Island
2020-03-01,WA,102,14,116,53,Washington
2020-02-29,WA,24,17,41,53,Washington
2020-02-28,WA,9,NA,9,53,Washington
2020-02-27,WA,2,NA,2,53,Washington
2020-02-26,WA,2,NA,2,53,Washington
2020-02-25,WA,2,NA,2,53,Washington
2020-02-24,WA,2,NA,2,53,Washington
2020-02-23,WA,2,NA,2,53,Washington
2020-02-22,WA,2,NA,2,53,Washington
2020-02-21,WA,2,NA,2,53,Washington
2020-02-20,WA,2,NA,2,53,Washington
2020-02-19,WA,2,NA,2,53,Washington
2020-02-18,WA,2,NA,2,53,Washington
2020-02-17,WA,2,NA,2,53,Washington
2020-02-16,WA,2,NA,2,53,Washington
2020-02-15,WA,2,NA,2,53,Washington
2020-02-14,WA,2,NA,2,53,Washington
2020-02-13,WA,2,NA,2,53,Washington
2020-02-12,WA,2,NA,2,53,Washington
2020-02-11,WA,2,NA,2,53,Washington
2020-02-10,WA,2,NA,2,53,Washington
2020-02-09,WA,2,NA,2,53,Washington
2020-02-08,WA,2,NA,2,53,Washington
2020-02-07,WA,2,NA,2,53,Washington
2020-02-06,WA,1,NA,1,53,Washington
2020-02-05,WA,1,NA,1,53,Washington
2020-02-04,WA,1,NA,1,53,Washington
2020-02-03,WA,1,NA,1,53,Washington
2020-02-02,WA,1,NA,1,53,Washington
2020-02-01,WA,1,NA,1,53,Washington
2020-01-31,WA,1,NA,1,53,Washington
2020-01-30,WA,1,NA,1,53,Washington
2020-01-29,WA,1,NA,1,53,Washington
2020-01-28,WA,1,NA,1,53,Washington
2020-01-27,WA,1,NA,1,53,Washington
2020-01-26,WA,1,NA,1,53,Washington
2020-01-25,WA,1,NA,1,53,Washington
2020-01-24,WA,1,NA,1,53,Washington
2020-01-23,WA,1,NA,1,53,Washington
2020-01-22,WA,1,NA,1,53,Washington
